ከ ለ ቀስተኞቹ መካከል አብዛኛዎቹ ጸሀዩ ዛሬ ተገለጠ ሀይለስላሴ ማሩን አለማችን አባታችን የ አፍሪካ አባት የ አለም አባት በ ማለት ነበር ሀዘና ቸውን የሚገልጹ	ከ ተማሪዎቹ መካከል አብዛኛዎቹ አካባቢው ዛሬ የ ተሟላ እንቅስቃሴ የ መኖሩ ን ባለሙያዎች አባታ ችን የ አፍሪካ አባት የ አለም አባላት በ ማለት ማስጠንቀቂያ ን የሚ ገልጿ ል
በ እስራኤል ኢራቅ ኢራን ን ሩሲያ ሩዋንዳ ማላ ዥያ ሊቢያ ላ ኦስ ስፔን ሶ ሪያ ወዘ ት ጋዜጠኞች እንደ ልብ የ መንቀሳቀሱ እድል እንደሌላ ቸው ድርጅቱ ዘግ ቧል	በ እስራኤል ሊቢያ ዩናይትድ ስቴትስ የ ሩዋንዳ ናይጄሪያ ሊቢያ ላቀስ ስፔንስ ኤፕያ ወርተ ጋዜጠኞች እንደ ልብ የ መንቀሰ በ እል እንደሌላ ቸው ቢ ገልጹ ተ ዘግ ቧል
በ ተጨማሪ ም የ ባንክ ቅርንጫፎች በሌለ ባቸው አካባቢዎች የ ብር ለውጡ የሚተገብሩ ሶስት መቶ የሚደርሱ ጊዜያዊ የ መለዋወጫ ጣቢያዎች መዘጋጀታቸው ን አቶ ዱ ባለ አስረድ ተዋል	በ ተጨማሪ ም የ ባክ ቅዳሜ ባንኮች በ ለ ባንኮች አካባቢዎች የ ተለመደው ት የሚ ቀብሩ ት ውስጥ መቶው የሚ ደርሱ ተግባራዊ የ መላው ኢንተርናሽናልዮቹ ገልጸዋል
የ አስመራ ው አምባሳደር ለ ኤርትራው ሬድዮ የ ሰጡት ቃል የ ዲፕሎማሲ ያዊ ተልእኮ አቸውን ለ መፈጸም እንጂ በ ትክክል ም የ አዲስ አበባው አምባሳደር የ ሰጡት መግለጫ ከ እውነት ርቆ አይደለም	የ አስሩ ው አምባሳደር ለ ኤርትራ ሬዲዮ የ ሰጡት ከባድ የ ዲፕሎማሲ ያዊ ዎቻቸውን ለ ማቋቋም እንጂ በ ትክክል የ አዲስ አበባው አምባሳደር የ ሰጡት መግለጫ ጥረት ተደርጐ አይደለም
ይህ እንዳይሆን በ ህይወታቸው መስዋእትነት ያስገኙ ትን የ ኢትዮጵያዊ ነት ክብር አንግ በ ን ለ ቅድስት ሀገራችን አንድነት ና ሉአላዊነት ሰላም ና ብልጽግና በ ህብረት እንቁ ም	ይህ እንዳይሆን በ ሂደታቸው መስዋእትነት የ መጡትች ም የ ኢትዮጵያዊ ነት እግር ኳስ ን ለ መንግስት ሀገራችን አንድነት ና ለ ሀገራነት ሰላም ና ግብጽድ ና በ ህብረት እን ውም
አንድ አነስተኛ ጉዳይ ለ ማስፈጸም በጣም ረጅም ቀጠሮ የሚሰጥ በመሆኑ ባለ ጉዳዮች ና ጉዳዮ ቻቸውን የሚከታተሉ ላቸው ጠበቃ ዎች ሲ ማረሩ ቆይ ተዋል	አንድ ሶስተኛው ን ጉዳይ ለ ማስፈጸም በቂ ችንን ቀጥሩ ይህን ይፋ በመሆኑኑ ባለ ጉዳዮች ና ጉዳዮች ን የሚ ከተሉ ላቸው በ ሰዎች ሲ ሞክሩ ተናግረ ዋል
በመሆኑ ም የ ኢትዮጵያ መንግስት ኢሮብ የ ኢትዮጵያ ግዛት ሁ ና እንድት ቀጥል እርምጃ ዎችን መውሰድ እንዳለበት ና የ ድንበር ኮሚሽኑ ም ያሳለፈ ውን ውሳኔ በ ድጋሚ እንዲ ያጤነው ጠይቀ ዋል	በመሆኑ ም የ ኢትዮጵያ መንግስት ግንባር የ ኢትዮጵያ ግዛት ዋ ና እንድት መካከል እርምጃ ዎችን መውሰድ እንዳለበት ና የ ድንበር ኮሚሽኑ ን ያሳፈው ውሳኔ በ ግዳጅ እንዲ ያገኝ ነው ጠይቀ ዋል
የ መስከረም አንዱን ጥቃት ቀድመው ካወ ገዙት አገሮች አንዷ የ ነበረችው ሱዳን በ ዘገባው ያለ መካተቱ ዋም ጥያቄ የሚ ያስነሳ ሊሆን እንደሚ ችል እነዚሁ አስተያየት ሰጪ ዎች ጠቁ መዋል	የ ስፔኑ ጥቃት ቀደምሞ ከ ካለው አገሮች አንዶ የ ሱዳን በ ዘገባው ያወጣ ን አርል ን ጥያቄ የ ሚያስችል ነጻ እንዲሆን እንደሚ ችል ለ ነዚህ ወጪው ይ ጠቁ ማል
በ ልመና ጊዜያችን ን ማጥፋት የ ለ ብን ም የሚ ል ወሬ የሚ ያራግቡ እንዳሉ ያስ ታወቀው ኢተፖድህ የ ህብረቱ የ ትግል ሰነድ ያለ ገባቸው ናቸው ብሏ ቸዋል	በትናንትናው ደቂቃችን ን ማጥፋት የ ለ ብን ንም የሚ ል ወሬ የሚ ያውቀውቡ እንዳሉ ያል ታወቀው ሊ ቆጣጠር የ ኢንቨስትመንት የ ትግል ሰይት ያለው በሚ ገባቸው ን ናቸው ብለዋል
ይህን እንደ አስፈላጊነቱ በ አካባቢው ሙያው ና ብቃቱ የ ሌላቸው ሰዎች ወይም በሚ ፈለገው መጠን በማይ ገኙ በት ወቅት የውጭ ዜጐች የሚ ሳተፍ በት እድል ይኖራል	ይህንን ያደረገፍ ናቶ ባ ቀበለው ው ና እውቀት የ ላቸው ሰዎች ወይም ም በት ተቀባይነት በ ማስመልከት በት ወቅት የውጭ ዜጐችች የ ምስክርነት ገፋበት እድል እንዲ ሰጣቸው ይገባል
ብሄራዊ የ ምርጫ ቦርድ በ ተደጋጋሚ ማስጠንቀቂያ ቢ ያስተላልፍ ም ሊሳካ አለመቻሉ ንና እንደ ውም በ አካባቢው ከ ምርጫ ጋር በ ተያያዘ ከፍተኛ ችግር እንዳይ ከሰት ስጋቱ ን ነው የ ገለጸው	ቢሊዮን የ እርምጃው ም በ ተደጋጋሚ ማስጠንቀቂያ ቢ ያ ም ም ሊ ሳካ ለ መቻል ና እንደ ው በ አካባቢው ከ ግምት ጋር በ ተያያዘ ከፍተኛ ችግር እንዳይ ፈጸሙት ዝርዝቱ ን ነው የ ሚባለው
የ አየር ሀይላችን አውሮፕላኖች ም ግዳጃ ቸውን በ ተገቢው ፈጽመው በ ሰላም ተ መልሰዋል ሲል የመንግስት ቃል አቀባይ ጽፈት ቤት መግለጫ አስ ታውቋል	የ አየርአችን ነዋሪዎች ም እጃቸው ን በ ተገቢ ተሰማው በ ሰላም ተ መልሰው ሲ የመንግስት ቃል አቀባይ ጽፈት ቤት መግለጫው አስ ታውቋል
የ ኢንተርኔት አገልግሎት ንም በ ተመለከተ በ ክልሎች በ ዞኖች ና በ አዲስ አበባ በ ተለያዩ ቦታዎች የ አገልግሎት ማእከሎ ችን ለ ማቋቋም መታቀዱ ን አብራር ተዋል	ይህንን ማግኘት አገልግሎት ን በ ተመለከተ በ ክልሎች በ ሌሎች ና በ አዲስ አበባ በ ተለያየ ቦታዎች የ አገልግሎት አገሮች ን ለ ማቋቋም መጠበቅ ን አዋጅ ተ ባለ
በዚህ ም አነስተኛ መስኖ ዎችን በ ማስፋፋት አገሪቱ ን በ ተደጋጋሚ ከሚ ያጠቃ ት ድርቅ ና የ ምግብ እህል እጥረት ለ ማቃለል እንደሚ ቻል ጠቁ መዋል	በዚህ ም አምስት ሚኒስትሮች ን በ ማስፋፋት ሀገሪቱ ን በ ጠጣኝ ግጥሚያ ጥቃት ቅቅ ና የ ምግብ እህል እጥረት ለ ማስተዋል እንደሚ ቻልን ጠቁ መዋል
ትላንት ጠበቆቼ መጥተው ስን ነጋገር እንግሊዘኛ ስላስ ገባ ን እኔ በ ም ሰማው ቋንቋ ካልሆነ አት ናገሩ ም አለ በዚያ ም ትወጣ ላችሁ ብለው ጠበቆቼ ን አስፈራሩ ዋቸው	ትላንት ክለቦች የ መጣው ስ ን ነገር እንዲ ገለጽኛ ስ ስገባ ን እንዲ ህ በ ምጽዋ ቋንቋ ሲሆን አትውቅ ም ለዚህ ምግብ አ ላቸው ብለው ተጫዋቾች ን አስ ታወቀ
በ ዝግ ስታዲዮም ጨዋታዎች የሚ ከናወኑ ት ቡድኑ ን ለ መቅጣት ሆነ ተብሎ በ ፌዴሬሽኑ አ ሊያ ም በኮን ፌዴሬሽኑ ውሳኔው ሲሰጥ ነው	በ ዚሁ ክስ የተገኘው ም ሰዎች የሚ መራው ት ቡድኑ ን ለ ማጥፋት ሆነ ተብሎ ብሎ በል ፌዴሬሽኑ አለ ያ ም በ ኮንል ፌዴሬሽኑ ውሳኔሩ ን ሲሰጥ ነው
ቅዱስ ጊዮርጊስ በ ዘንድሮ ውድድር ላይ ጠንካራ ተፎካካሪ ለ መሆን የ ባንኮቹ ን አንተነህ ፈለቀ ንና የ ኢትዮጵያ ቡና ቴዎድሮስ በቀለ ን አስ ኮብል ሏል	ቅዱስ ጊዮርጊስ በ ዘንድሮ ውድድር ላይ ቀን ካራካሬ ለ መሆን ና ባንኮች ን አንተነለራ ንና የ ኢትዮጵያ ቡና ና የድሮስ በደል ን አስ ሯል
ነገሮች ን በ ጥልቀት መመርመር ና ማስረዳት የ ዘወትር ስራዋ የ ሆነው ሀያል ብእረኛ ና በ ሳል ገጣሚ ፍር ማ ዬ አለሙ የ አንዲት ሴት ልጅ እናት ነበረች	ነገሮች ን እንደሌላት መርር ና ማደራጀት የ ሰሩት ስራዋ የ ሆነው አቋም በረኛ ና በ እስራኤል አጼ ሚንሊክ የመንግስት ሴት ሀይሎች እንዳሉት አለ ች
እነዚህ ከ ብዙዎቹ የ ጾም ደረጃዎች ጥቂቶቹ ሲ ሆኑ በ ጨዋታ ና ያለቁ ም ነገር ሌሊቱ ን ሙሉ በማ ምሸትና ረመዳን በ መምጣቱ የምን ጨነቅ ና የሚ ከብደን መሆን የ ለ በት ም	እነዚህ ከ ብዙዎቹ የ ዞን ደረጃዎች ጥቂቶች ሲ ሆኑ በ ጨዋታ ና ያለፉ እል ሊ ሉት ን ሙሉ በ መግዛት ና ልምዳ ን በ መምታቱ የሚቻል ነው የሚናገሩ ን የ ለ በት
ለ እናንተ ነገርኳችሁ እንጂ እግዚ ዮ በሉ እያ ለ ህዝቡ ሲያስ ለቅስ ም ላስ የሚ ያወጣ ባህታዊ አለ አላልኩ ም	ለ እናንተ እውቀት እንዲ ህ እርቅ ሲ ሆኑ ብሉ እ እያ ለ ስቶ ሰለሰስ ምላሽ የሚ ያውቅ በታዊ አለ አላልኩ ም
የመን ከ ኤርትራ ጋራ በ ደሴቶች ግጭት ስላላ ት የ ጠላታችን ጠላት ወዳጃችን ነው በሚል ብን ይዛት ሀያል ት ሆነ ናለች በሚል ተስፋ ነው	ይሄን ከ ኤርትራ ጋር በ ደበ ቶች ትልቅ ታላላቅ የ ጣታችን ን ጠላት ወደ ደረጃ ነው በሚል ግን እሳት ሀ ያልፈል ት እንዴት ተስፋ ነው
የ ድንበር ማካለል ሂደቱ ን በ አፋጣኝ ግቡ ን እንዲ መታ አለም አቀፉ ህበረተሰቡ ን አስ ፈላ ጊ ውን እገዛ እንዲያደርግ ጥሪ ይቀር ባል	ለት በ ማጠቃለል ሂደቱ ን በ አባይጋቡ ን እንዲ ህ እና አለም አቀፍረሰቡ ን አስ ተላልብ ቢሊዮን በ እገዛ እንዲ ያደርግ ተደርጓል
ከዚያ ም በ አንዳንድ አውሮፕላኖች ላይ የተወሰኑ ብ ልሽ ቶች ተከስ ተዋል የሚ ል ዘገባ እንደ ቀረበ ማኔጅመንቱ አስራ ስምንቱ ን ቴክኒሺያኖች ሊያሰ ና ብ ቷ ቸው እን ደበቁ ተ ዘግ ቧል	ከዚያ ም በ አንዳንድ ወገኖች ላይ የ ደረሱኑ ድርጅቶች ተቀባይነት የሚ ል ዘገባ እንደ ዘገበው ማንቸስተቱ አስራ ስምንት ቴክኒክ ቶችኖች ሊ ያስረዳቸው እንደ ነበረ ት ተ ዘግ ቧል
ዛሬ ና ነገ በ ሀገሮች የ ውስጥ ውድድር በ ሳምንቱ አጋማሽ ላይ ደግሞ በ አውሮፓ ቻምፒየንስ ሊግ እንዲ ሁ በ ጉጉት የሚ ጠበቁ ጨዋታዎች ይደረ ጋሉ	ዛሬ ና ነገ አገሮች የ ውስጥ ውድድር በ ሰአቱ ቅዳሜ ላይ ደግሞ በ አውሮፓ ኢንሹራንስ ሊግ እንዲሁም በ ሞት የሚጠበቅ በት ሰዎች ይገልጻሉ
ሁለቱ ሀይሎች በ ቅርብ ርቀት ውስጥ እንደሚገኙ ም ለ ማስረዳት የ ሞከረች ው በ ሻእቢያ ወታደሮች ምሽግ ውስጥ በ መሆን የ ኢትዮጵያ ወታደሮች እንቅስቃሴ ይታ ያል በ ማለት ነው	ሁለቱ አገሮች በ ቅርብ ጥቃት ውስጥ እንደሚገኙ ለ ማስገባት የ በኩላቸው በ ሻእቢያ ወታደሮች ውሽ ውስጥ ለ መሆን የ ኢትዮጵያ ወታደሮች እንቅስቃሴ ይታ ያል በ ማለት ነው
በ ተጨማሪ መንግስታት ና የ ሰብአዊ መብት ተሟጋች ድርጅቶች የ ሱዳን መንግስት የ አሰ ራቸውን ኦሮሞዎች እንዲ ፈታ ጫና እንዲያደርግ ጠይቋል	በ ተጨማሪ መንግስታት ና የ ሰብአዊ መብት ተጣጭ ድርጅቶች የ ሱዳን መንግስት የ ራሳቸው ን ኦሮሞዎች እንዲ ፈታ ለማስቻል ያደርግ ተ ጠይቋል
አቅም በሚ ፈቅደው መሰረት አስቀድሞ መዘጋጀት ስለሚ ፈልጉ የሚ ያጠራጥር አይሆን ም ስትል የ አሜሪካ ድምጽ ዜና ዘጋቢ ገልጻ ለች	አገሪቱ ም በሚ ፈቅደው መሰረት አስቀድመው ነጻነት ስለሚ ፈልግ የሚ ያስተዳድርሆን ም ስትል የ አሜሪካን ድምጽ ዜና ያስረዳ ል
በዚህ አመት መጨረሻ ሀምሌ ወር ወይን ም በ ሚቀጥለው አመት የመጀመሪያ ወራት እነ ዶክተር ታዬ የመጨረሻ ውሳኔ ያገኛ ሉ ተብሎ ተገምቷል	በዚህ አመት ማምሻው ም ወርር ወይን ም በሚ ቀጥለው አመት ይህንን የ ጀመረው በ አራት ነጥብ ዶክተር ታዬ የ መጨረሻርሻው ውሳኔ ያገኘው ም ተብሎ ት ገልጠዋል
ደግሞ ም ባሏ ንና ልጅዋ ን ከ አጀብ መሀል የምት ፈልግ ሴት ባሏ ን ብታገኝ ደስ ብ ሏት ልጅዋ ንም ብታገኝ አገላብጣ ስማ በ ደስታ ታለቅ ሳለች	ደግሞ ም ባለው ንና ልጇ ን ካካ መሀል የሚ ልክሴት ባገኘ ን ት ተ ገልጿ ል
ነገር ግን ቼልሲ ለ አውሮፓ ሱፐር ካፕ ከ ቻምፒየንስ ሊግ አሸናፊ ከ ሪያል ማድሪድ ጋር ባለ በት ጨዋታ ምክንያት ወደ ሌላ ቀን ተዘዋው ሯል	ነገር ግን ሼህ ለ አውሮፓ ሱፐር ካፕ ከ ፎር ኬስ ሊግሽ ሪያል ማድሪ ጋር ባለ በት ጨዋታ ምክንያት ወደ ሌላ ቅዳሜ ተ ዘግ ዋል
የሚ መደበው ገንዘብ ተሟልቶ ካለቀ በኋላ የ ሚከተለው ን ችግር ከ ግምት ውስጥ በ ማስገባት የተለያዩ ገቢ ማስገኛ ዘዴ ዎችን መቀየሱ አስፈላጊ ነው	የሚ መራው ግን ገንዘብ ተሰጥቷ ን ካለ በኋላ የ ሚከተለው ን ችግር ቀናት ውስጥ በ ማስጠበቅት የተለያዩ ገቢ መስሪያ ቤቶች ን በ አልጀርስል የ ለ ም
በዚህ ረገድ አይ ኤም ኤፍ እቅዱ የሚ ሰጠው ብድር በ ድርጅቱ ትእዛዝ እስካል ተፈጸመ ድረስ የ ነጻ ገበያው ን መርህ ማራመድ አይችልም	በዚህ ለ ዳዊ ሚንሊክ ዲዱ የሚ ሰጠው ውድድር በ ድርጅቱ ትእዛዝ ስጦታ ተጽእኖ ሲ የ ነጻው ጉባኤው ን መርር ማቅረብ አለ ን
ደን ቤ መንጉል በ አወዛጋቢ ዋ የ ባድመ መንደር አካባቢ አራት መቶ ሜትር ያህል ለ ኤርትራ ወደ ተወሰነው ግዛት ገባ ብላ የምትገኝ ና ት	ደንቡ የ ም ንም ኩነዛ ዘገባው የ ባመ ም ንግድ አካባቢ ሀያ አራት አመት ሚኒስትር የ ሀይል ለ ኤርትራ ወደ ስፍራው ግዛት ገባ እዚያ የ ም ትገኛ ለች
የኤርትራ ማእከላዊ ባንድ ቦንድ በ መሸጥ ኢኮኖሚው ን ለ ማረጋጋት የሚ ያስችለው ን ገቢ ለማ ሰባስብ እንቅስቃሴ መጀመሩ ን በ ቅርቡ የ ዘገበው ሮይተር የ ተሰኘው የ ዜና አውታር ነው	የኤርትራ ማእከላዊ ባንክ አሁን በ መሸጥ በ ኢኮኖሚው ን ለ ማጥፋት የሚ ያስችለው ን ገቢ ለ ማስብ እንቅስቃሴ የ ምሩ ን ጥገበ ው የ ት ተብሎ የ ዜናውተር ነው
ነገር ግን የኤርትራ ን ወረራ መቀጠል ም ሆነ የ መሬታቸው ግማሽ ወደ ኤርትራ መካለል ና የ ህዝባቸው ለ ሁለት መከፈል የሚ ዋጥ ላቸው አይሆን ም	እቅዱ ግን የኤርትራ ውያን መካከል ሆነ የ ሌላቸው ግማሽ ወደ ኤርትራ መመለስ ና የ ህዝባቸው ለ ሁለት አመታት ሊ ያወጣ ላቸው ብቻ ም
ሻእቢያ እነዚህ ን አካባቢዎች ለ ማግኘት ፍል ጐ አለማግኘቱ ና ማጣቱ ድርብ ሽንፈት ውርደት አግኝቶ ታል ለማ ለት ይቻላል	ሻእቢያ እነዚህ ን አካባቢዎች ለ ማግኘት ተችሏል
የ አካባቢ ጥበቃ ቡድኖች ና ተመድ ዲዲቲ ን በ መቃወማቸው ና መንግስት ም ዲዲቲ ን ቸል በ ማለቱ ሳቢያ ሰዎች በ ወባ ሲ ያልቁ ትልቅ ወንጀል ነው በ ማለት ወቅሰዋል	የ አካባቢው ነዋሪዎች ና ተመድ እድገት ን በ መቃወማቸው ና መንግስት በ መገኘት ይልቅ በ ማስወጣቱ ሳቢያ ሰዎች በ ሞባይል እንኳ ን ብለው ለ መረዳት ተችሏል
ሰራዊቱ ይህ ሳይ በቃው አለቆቹ ለ ውድቀቱ ተጠያቂ ናቸው በመ ባል መታመ ሳቸው ከፍተኛ ውጥረት ን በ ጦሩ ውስጥ ያ ሰፈነ መሆኑ ም ተመልክ ቷል	ሰራዊቱ ይህ ኢሳያስ በ ገዛው ያቹ ለ ውጥረቱ ተጠያቂ ናቸው በ መሀል መብት ራሳቸው ከፍተኛ ትኩረት ን በ ጥሩ ውስጥ ያስረዳ መሆኑን ም አመልክ ተዋል
ፕሬዝዳንት ኢሳያስ አፈወርቂ መንግስታቸው ኢህአፓ ንና ኦነግ ን ይረዳ ል በሚል ለ ቀረበላቸው ጥያቄ ኢህአፓ ንም ሆነ ኦነግ ን መንግስታቸው እንደማይ ረዳ ገልጸዋል	የ ፕሬዝዳንት ኢሳያስ አፈወርቂ መንግስታቸው እያ ባን ና ው ን ይረዳል በሚል ለውጥ ጥያቄ እንዲ ያገኝኑ ሆነ ሆነ ን መንግስታቸው ን እንደማይ ገልጿ ል
ይህንን የ ኢትዮጵያ ወታደሮች እርምጃ የ ሱማሌ ላንድ ተጠሪ እውነት ሲሉ እንዳ ረጋገጡ ት የ ቢቢሲ ሬድዮ የ ሀርጌሳ ው ዘጋቢ ባሳ ለፈው የ ስልክ ዜና ላይ ገልጿ ል	ይህንን የ ኢትዮጵያ ወታደሮች ከባድ የ ሱማሌ አንጃ እውነት ሲሉ እንዳደረጉ ት የ ሚገኘው የ ኢህአዴግ አስተዳደር ባለፈው ው ለ እስር ክፍል ላይ ተ ገልጿ ል
ይህ ደግሞ የ አንድ እምነት ተከታይ ነታቸውን እንጂ የ ህዝቡ መጠሪያ ሆኖ ሊ ያገለግል የሚችል ስያሜ እንዳልሆነ ግልጽ ነው	ይህ ደግሞ የ አንድ እምነት ተሰጥቷ ቸውን እንጂ የ ህዝብ ው መጠያያ ሆኑ ሊ ያገለግሉ የሚሄዱ ን ስ እያሉ እንዳልሆነ ገልጽ ነው
ነጻ አመለካከ ቶችን ለ ማራመድ ገና ጀማሪ ዎች ሆነ ን ብን ገኝም በ ዘመናዊ ው አለም ያለ ን ሁሉ የ ኢንፎርሜሽ ን ን አስፈላጊነት አጠቃቀም ን በሚገባ እናውቃለን	እነዚህ ወጣቶች ን ለ ማቋቋም ገና ተማሪዎች ን እንደምት ገኝ በ ጀርመን አለም ያለ ን ሁሉ የ ኢንፎርሜሽ ን አላማውነት አይቀም ን በሚገባ ነው አለ
ስለዚህ አሰልጣኙ ራሳቸው ን ብቻ እ ያዳመጡ ከ ፍላጐታቸው አል ነቃነቅ ብለዋል በ ማለት አርሴ ናል ከ ቻምፒየንስ ሊግ ከ ወጣ በኋላ የ እንግሊዝ የ ስፖርት ጋዜጠኞች እየ ጻፉ ነው	ስለዚህ አሰልጣኙ ው ራሳቸው ን ብቻ የ ያስተዳድጡ ክፍል ፍላጐታቸው አልተነቃ ል ብለው በ ማለት አጼ ን ከ ቴንስሊክ ት በኋላ የ እንግሊዝ ስፖርት ጋዜጠኞች እየ ጣፉ ነው
የመጀመሪያ ው ነጥብ በ ተቃዋሚ ሀይሎች ሰፈር በ ጋራ አቋም ላይ በ ጋራ ለ ማቆም ያየነው ጽናት አነስተኛ መሆኑ ነው	የመጀመሪያ ው እውነት በ ተቃዋሚ ሀይሎች አስተዳደር በ ጋራ አደጋ ላይ በ ጋራ ለ ማቋቋም ያገኝ ነው
በግል ትምህርት ተቋማት የሚ ያስተምሩ የ ዩኒቨርስቲ መምህራን መንግስት ደመወዝ ከሚ ከፍላቸው ስራ ውጪ በሌላ የ ትምህርት ተቋማት እንዳ ያስተምሩ የሚ ያግድ አዲስ ደንብ አዘጋጅ ቷል	በ ክልል ትምህርት ተቋማት የሚ ማቅሩ የ ዩኒቨርስቲ ም ን መንግስት ለ ማቋቋም የሚያስፍ ላቸው ስራዎች በሌላ ትምህርት መሰረት እንዳይ ኖሩሩ የሚ ያግ አዲስ ጣቢያዛ ቷል
ህወሀት ኢህአዴግ ታድ ሻለሁ ከ ማለቱ ና ቀውሱ ከ መፈጠሩ በፊት ፖሊስ በ ፍትህ ሚኒስቴር ስር እንደ ነበር ሲ ታወቅ ፍትህ ሚኒስትሩ ም የ ህወሀት ሰው እንዳል ነበሩ ይታ ው ሳል	ህወሀት ኢህአዲግ ታሽ ያለው ከ ማለት ና ክሱ ት በስተቀር በፊት ፖሊስ በ ፍቅር ሚኒስቴር ስር እንደ ነበር ሲ ታወቅ ም ሚኒስትሩ ም ህወሀት እንዳለ ባቸው ይታወ ቃል
በ አሁኑ ወቅት አብያተ ክርስትያ ና ቱ የ ተዘጉ በት ምክንያት ም ን እንደሆነ እንዲ ነገራቸው አንዳንድ አለም አቀፍ የ ወንጌል አገልግሎት ድርጅቶች መንግስት ን እየ ጠየቁ መሆኑ ም ታውቋል	በ አሁኑ ወቅት ቀናት የ ተዛባ በት ምክንያት ም ን እንደሆነ እንዲ ነሱ አንዳንድ ለአፍሪካ የ ውንግድ ድርጅቶች ድርጅቶች መንግስት ን እየ ተፈለገ መሆኑኑ ታውቋል
በዚህ አስታ ከ ው ስደተኛው እምቢ ያለውን መዋጮ በ ግድ እንዲ ያዋጣ ለማድረግ በዋናነት የተወጠነ ሳይሆን እንዳልቀረ ም ግም ታቸውን የሚያ ሳርፉ ወገኖች አሉ	በዚህ ያስ ታው ስደተኛው እንዲ ህ ያለውን ማስረጃው በ ግልጽ እንዲ ያዋጣ ለማ ደግሞ እናነት የ ጦር መሳሪያ ሳይሆን እንዳል ከ ግምታቸው ን የሚያሳፉ ወገኖች አሉ
በ ምክር ቤቱ ወንበር አነስተኛ ቁጥር ያ ላቸው ተቃዋሚዎች የፖለቲካ ፓርቲዎች በ ግምገማው ተሳታፊ አለ መሆናቸው ቅሬታ እንዳሳደረ ባቸው ከ ፓርቲዎቹ አባላት ለማወቅ ተችሏል	በ ምር ቤቱ ውረያ ቁጥር ያ ላቸው ተቋምው ትኩረት ከ ከፈተች በ ወገን ደግሞ ስህተት ያለ መሆናቸው ንም ቅሬታ እንዳ ላቸው ከ አዋቂዎቹ አባላት ለማወቅ ተችሏል
አምባሳደር ባድር በ ሁለት አገሮች ያሉ የ ንግድ ሰዎች የበለጠ ለ መስራት እንዲችሉ አጋጣሚ ዎች መጠቀም እንደሚ ችሉ ም አስምረው በታል	ፕሮፌሰር ባሻገር በ ሁለት ወታደሮች ያሉ የ ንግድ ሰዎች የ በጀት ነጥብ ለት እንዲ ህ ትልቁ አ ኞች መጠቀም እንደምን ችልዱ ን አስ ረው በታል
የ ሀዲያ ልማት ማህበር ተፈራ መ ኬ ምክትሉ ደስታ ዳኜ ዘጠኝ ና ስድስት አመት ተ በይኖ ባቸዋል ሲል ይ አ ው የ ዜና ዘገባ ጨምሮ ገልጿ ል	የ አአድ የ ልማት ግንባር ተቀባይነት ምክትልሉ ፕሬዚዳንት ታንዛኒያ ዘጠኝ ና ስድስት አመት በ ይኖር ባቸው ይኸው የ ዜና ዘገባው ጨምሮ ገልጿ ል
ላዚዮ ዎች እያ የ ሉ በ መምጣት የ ቺሊ ው ሳላስ ኳስ ይዞ ሲገባ በመ ጠለፉ የተሰጠ ውን ፔናልቲ ራሱ በ ማስቆጠር ላዚዮ ሶስት ለ አንድ መምራት ጀመረ	ለ ሌሎች እያሉ የ ምግብ የ ልኡካንላ ቀውስ ሲ ሰሩ ሲገልጹ የተሰጠ ን ስነ ልት የ ራስኑ ን አስር ላዚዮ ሶስት ለ አንድ ቀናት ጀመረ
በ ትግራይ ህዝብ ስ ም የ ተቋቋመው ኤፈርት አዲስ የ ቴሌቪዥን ጣቢያ ሊ ከፍት መሆኑን ለ ጋዜጣዋ ዜና ዴስ ክ በ ኢንተርኔት የ ደረሰው ዘገባ አ መለከተ	በ ትግራይ ህዝብ ስ ም የ ተቀሩት የ ቴዎድሮስ ፌዴሬሽን ደንብ ሊ መሰርት መሆኑን እንዳስደርስ ኤሲ ሚላን ኢንተርኔት የደረሰ ውን ዘገባ አ ጸደቀ
ሚኒስትሯ የቢሮ ውን የ መድሀኒት ስርጭት ሀላፊ ማነጋገራቸው ን ጠቅሶ ግለሰቡ ሀኪም አለመሆኑ ንና የ ህክምና እውቀት እንደሌለ ውም አስረድ ቷቸዋል በ ማለት አ ስፍሯል	ሚኒስትሩ የ ቢሮው ን የ መግዛት ፍርድ ቤት ማካሄዳቸው ን ጥሱ ህዝቡ ካ ባለ መሆኑኑ ና የ ህክምናቀት እንደሌለ መልእክታቸው ን ለ መረዳት ተችሏል
በመሆኑ ም ሌሎች ክልሎች ም ከዚህ በ መማር ዜጐቻቸው ን ከ አደገኛ እጾች ለ መከላከል በ የ በኩላቸው ህግ ና ደንብ ሊ ያዘጋጁ እንደሚ ገባ መግፋት ና መገፋፋት ተገቢ ይመ ስላል	በመሆኑ ም ሌሎች ክልሎች ም ከ ከዚህ ሚኒስቴር ልጆቻቸው ን ከ ኢህአዴግ ሶች መከላከል በ የ በኩላቸው ን ህግ ና ደንብ መስራት እንደሚ ገባ መግዛት ና ማስፋጥ ተ ገልጿ ል
በ ስምንተኛው ደቂቃ ላይ አንድ የ ግሬሚዮ ተጫዋች ከ ፔናሊቲ ውጪ ተመትቶ ቅጣት ተገኝቶ ቅጣቱ ም ተ መቶ በ ግራው ቋሚ ብረት ተመል ሷል	በ ስምንተኛው ደቂቃ ላይ አንድ የ እግር ሚስተር ጄት ቴክኒክቲ ውጪ የ ተሟላ ቅጣት ተገኝተው ከ ጠዋቱ ን ተ መቶ በሚያው እንኳ ን የ ፕሮጀክት አልቻለ ም
አቶ አለማየሁ ዘገየ በ ጸረ ሙስና ኮሚሽን ክስ ላይ መካተታቸው ን ከ ጋዜጦች ላይ ከማን በ ባቸው ውጭ የ ፍርድ ቤት መጥሪያ እንዳል ደረሳችው መናገራቸው ም ተጠቁ ሟል	አቶ ጸሀዬ ወልደማዊ በ ጸረ ሙስና ኮሚሽን ክስ ላይ መገኘታቸው ን ከ ሀላፊነቱ ላይ አሁን ባቸው ውጪ የ ፍርድ ቤት ማድረግ እንዳለ ባቸው በ መናገራቸው ም ተጠቁ ሟል
ከዚህ ም ሌላ የ ቴሌቪዥ ኗ ጋዜጠኛ እንግዳ ዘር ነጋ እግሯ ን ኦፕራ ሲ ዩን የ ሆነች ሲሆን አሁን ከ ኦፕራ ሲዮኑ በኋላ በደህና ሁኔታ ትገኛ ለች ሲል ጠቁ ሟል	ከዚህ ሌላ ሌላ ለ ፌዴሬሽኑ ሀሙስ ገንዘብ ከፊሎቹ ን ኳስ ሲሆን የ ኦሎምፒክ ሲሆን አሁን ኮሪያ ሲሉ በኋላ በ ደንብ ሁኔታ ት ላይ እንዲያዝ ሲናገሩ ይታወ ቃል
ትኩረት ሊ ሰጠው እንደሚ ገባ እየ ገለጽ ን አስፈላጊው መልእክት በ ቀጥታ የ ሚመለከታቸው ን ሁሉ በ መወያየት ተጨማሪ መልእክት ለ ማስተላለፍ እንደምን ችል ተስፋ እናደ ጋለን	ትኩረት ሊ ሰጠው እንደሚ ገባ የ ገንዘብ አስተዳዳሪ ው መልእክት በ ቀጥታ ይመለከታቸው ን ሁሉ በ ውያት የ ተጨማሪ መልእክት ለ ማስጠበቅፍ እንደምች ተስፋ እናደርጋ ለ ን
በ ዚሁ ስብሰባ ላይ የ ኬንያ ና የ ሩዋንዳ ሚኒስትሮች ያልተገኙ ሲሆን የ ሁለቱ ም መንግስታት ተወካዮች ግን በ ስብሰባው ላይ መገኘታቸው ታውቋል	በ ዚያው ስብሰባ ላይ የ ኬንያ ና የ ሩዋንዳ ሚኒስትሮች ተወካዮች ሲሆን የ ሁለቱ መንግስታት ተወካዮች ግን በ ስብሰባው ላይ መገኘታቸው ታውቋል
ለ አላህ መገዛት ማለት እንዲ ሁ በ ቀን አ ም ስቴ ከ ፊቱ መደ ፋት ማለት አይደለም ለህ ግጋ ቶቹ ና ትእዛዛቱ ም ን ጊዜ ም ታዛዥ ሆኖ መገኘት ማለት ነው እንጂ	ለ አለም አባላት ማለት እንዲ ሁ በ ቀን መንግስት የ ሚያደርጉት መብት ማለት ለ ም ለ ዲፕሎማቶቹ ና ጥናቱ ም ን ጊዜ እንቀሉ ነው መገኘት ማለት ነው እንጂ
በ ብዛት ግን በ የ መንገዱ ዳር በ የ በረንዳ ው ላይ ም ለ ማደር በ መከልከላቸው ማይ ሀብ ሀብ የተባለ የ ከተማው ቆሻሻ ማጠራቀሚያ ቦታ የሚያድሩ መሆኑን ገልጠዋል	በ ብዛት ግን በ የ ዞን እዳ በ የ ኦሮሚያ ላይ ም ን ለማድረግ በ ክልል ከ ላቸው የ ሀያ አመት እየተ ባለ ማጐሸያ መፈረም እንዳለበት ቦታ የሚያሩ መሆኑን ገልጠዋል
ከዚህ ም ሌላ ባል ተረጋገጠ ምንጭ በ ቀረበ ዜና ከ ፈረንሳይ ጋግል የተባሉ ሄሊኮኘተሮች ና ሌሎች ም ተዋጊ አውሮኘላኖ ች ጂቡቲ መግባታቸው ታውቋል	ከዚህ ም ሌላ ባል ተቀባይነት ም እንጂ የዚህ ከ ፋይና ሳይ ይጋል የ ተባለው ሪፖርተሮች ና ሌሎች ም የ ሱማሊያ ከተሞች ጅቡቲ መግባታቸው ታውቋል
የ ሼህ አላሙዲ ን ሀብት በ ሰንጠረዡ ላይ የ ተመለከተው ብቻ እንዳልሆነ ና ይህ ዝርዝር በተገኘ መረጃ ላይ ብቻ ተመስርቶ የ ተጠናከረ መሆኑን ለ መረዳት ተችሏል	ከ ፊህ አላሙዲ ን አርቲስት በ ስንንሩ ዙሪያ ላይ የ ተመለከተ ብቻ እንዳልሆነ ና የ ዜና ዝርዝር በ ተደጋጋሚ ላይ ብቻ ተርፍቶ እየ ተናገሩ መሆኑን ለ መረዳት ተችሏል
ከዚህ ም ሌላ ሆስፒታሉ አምስት ፐርሰንት የ ተጐዳ ሲሆን መገልገያ መሳሪያዎቹ በ ሙሉ ከ ጥቅም ውጪ መሆናቸው ን የ ድርጅቱ ሀላፊ ከ ኖርዌይ ለ ቢቢሲ ገልጠዋል	ከዚህ ም ሌላ ውስጥ እስከ አምስት ፐርሰንት የተባለ ሲሆን እቅድ ቅያ ዎች በ ሙሉ ከተሞች የ መሆናቸው ን የ ተሟላት ነው
ማህ ላው ም ሆነ ጋብቻው ም ስሜ ቷን የሚ ኮረ ኩራት ፍጥረት ባት ሆን ም እንዲ ሁ እ ያደናገረ ወደ ጫካ ይዟ ት ገባ	ፓርላማው ም ሆነ አገራቸው ም ክቡራን ን የሚ ያውቁት ት ጥረት አባቱ ን ም እንዲ ሁ እ ያደርግ ወደፊት አባባል ይዙ ገባ
በሌላ በኩል ስርቆት ና መሰል ወንጀሎች ን ምክንያት አድርጐ በርካታ የ መቀሌ ከተማ ነዋሪዎች በ መታፈስ ላይ መሆናቸው ታውቋል	በሌላ በኩል መባረር ስርት ና መስሪያ ቤቶች ን ምክንያት ማድረጉ በርካታ የ መጠለ ከተማ ነዋሪዎች በ መታ ተስፋ ላይ መሆናቸው ታውቋል
በ ተጨማሪ ጋዜጠኛ ታምራት ዙማ የ አስራ ስድስት ሺ ብር ዋስ በ ማጣቱ ለ ከፍተኛ እስር ና ስቃይ መዳረጉ ይታወሳ ል	በ ጠቅለይ ሚንስተር መለስ ዜናዊ ታንዛን ም የ ሀያ ስድስት ሺህ ዶላር ኳስ በ መላጡ ው እ ለት እስር ቤት ና እስራት ይታወሳ ል
እኔ ራሴ የ ት ቦታ ሆኜ ስራዬ ን እንደም ሰራ አላውቅ ም ማለታቸው ን ከ ቢቢሲ በሚ ተላለፈው ፎከስ ኦን አፍሪካ ፕሮግራም ላይ አስደም ጧል	እኔ ራህ የት ቦታው ን የ ሰላም ም ን ደም ም አለ ው ም ማለታቸው ን ቢ ያውቅ ም ትችላፈው ልናል
በዚህ በ ሀንቲንግተን የ ስልጣኔ ዎች ሰንጠረዥ መሰረት ኢትዮጵያ ችን የ የትኛው ስልጣኔ ክበብ አባል እንደሆነ ች ማወቁ ባል ከፋ	በዚህ በ አንድ ቴክኒተን የ ስልጣዎች ሰንደቅ በ መሰረት ኢትዮጵያዊያ ን የትኛው ስልጣን ተቋም እንደሆነ ማወቅ አልተቻለ ም
እንደ ተማሪው አቋም ትምህርት ለ ማስጀመር የ ደህንነት ዋስትና ተሰጥቶ ሁሉን ም ተማሪ ያሳተፈ አጠቃላይ ውይይት መደረግ አለ በት	እንደ ተማሪው አቋም ት ጥረት ለ ማጠናከር የ ደህንነት ዋስትና ተሰጥቶ ሁሉም ምላሽ እውቀት ጠቅላይ ውይይት መደረግ አለ በት
የ ሀገር አስተዳደር ሚኒስትሩ ልዩ ረዳት በ መሆን ካ ገለገሉ በኋላ በ ቴህራን ና በ ቴልአቪቭ የ ጀርመን ኤምባሲዎች ውስጥ ተመድበው አገልግ ለዋል	ያ ነጋር ሚኒስትሩ ሊ ረዳት በመሆኑ ከ ታግደ በኋላ በ ፌዴራል ና በ ተለያዩ ጀርመን ኤምባሲዎች ውስጥ ተመልክተው ብለዋል
በ ነዚህ ጠማሞች ክፉ አሳቢ ዎች ምክንያት የምና ኔ ህይወት የሚ ገፉበት አለም እስከ መሆን ደር ሳለች	በ እነዚህ ከተማ ግማሽ ክፉ ቤቶች ምክንያት ይኸው የ ህይወት የሚ ደረገው በት ም አለም እስከ መሆኑን ደርሷ ል
የ አይነ ስውራን የ ብራል ጋዜጣ ና የ ጉልህ ህትመት መጀመር ዛሬ በ ሂልተን ሆቴል ይፋ እንደሚሆን የ ኢትዮ ኒውስ የ ብራል ጋዜጣ ዋ ና አዘጋጅ ገለጹ	የ ሳምፕዶሪያ ን የ እግር ኳስ ና የ ሪፐብሊክ መብት መጀመር ታ ሊይ ተርሞ ሊፋቸው ን የ ኤርትራውያኑ ሲ ያውቅ የ ተሟላ ና መሳሪያ ዎች ገለጹ
ክላስተር ቦምብ በ ትግራይ ነዋሪዎች ላይ እንደ ተወረወረ የ ሰማሁት እዚህ አሜሪካ የሚ ታተሙ ጋዜጦች ና ራዲዮ ዎች በ ሰፊው ሲ ዘግቡ ነው	የተ ለቀቁት ምርኮኞች በ ትግራይ ነዋሪዎች ላይ እንደ ተሰማር የ ልማት እ ለት ይፋ የሚ ሰጠው ጉዳዮች ና ሀላፊዎች በፊት ሲ ስማሙ ም
በ ልጅነት ዘመናቸው ጊዜ የ ሙት ልጅ ሆነው ም ባገኙ ት ብልጫ ወደ ኤደን ብራ እንግሊዝ በ መላክ የመጀመሪያ ው ተማሪ ነበሩ	በዚህ ና ዘመናቸው ጊዜ የ ሞት ሀላፊዎች ም ባ ገኙ ትልቅ ወደ ሜዳሊያ በ መላእክት የመጀመሪያ ው ጥሪ ነበሩ
እንዲያ ውም ብዙዎች ኤርትራውያን ሻእቢያ በ ኢትዮጵያ ላይ ለ ከፈተው ወረራ ም እየ ተጠራጠሩ መምጣታቸው ን ሰሞኑ ን ከ አስመራ የሚ ወጡ ወሬ ዎች ያስረዳ ሉ	እንዲያ ም ብዙዎች የ ኤርትራውያን ሻእቢያ በ ኢትዮጵያ ላይ ለ ካድሬው ቁጥጥር እየ ተጠናከሩ መሆናቸው ሰሞኑ ን ከ አስመራ ላይ ደረጃዎች ያስረዳ ል
ባልተ ለመደ ሁኔታ ም ለ ብዙዎቹ የ ነዳጅ ቦቴዎች ተሰናክ ሎ በ የ ገራ ዡ ና በ የ ቤቱ መኮልኮል ም ዋናው መንስኤ ይ አ ው መሆኑ በስፋት እየተነገረ ነው	ባጠቃላይ ለምን ሁኔታ ም ብዙዎቹ የ ነዳጅ ማጣሪያ ዎች ተፈናቅሎ በ የ ራሳቸው ና በ ሌሎች መልኩ ም ዋናው መስሎ መሆኑን በስፋት እየተነገረ ነው
የ ድርጅታችን ህግ አስከባሪ ሀይል ኦዲት ኮሚሽን በ ነሱ ላይ ፍርዱ ን ሲ ያሳርፍ ድሮው ንም እ ያወቁ ኩዴታ ያደረጉ በ መሆናቸው ሊቀበሉ አል ፈለጉ ም	የ ድርጅታችን እ ኳስ የ ሀይል ኳስ ኮሚሽን በ እነሱ ላይ ያተኮዱ ሲ ሰረፍሩ ን ሊ ያቁ ው ውጤት ያደርግ በ መሆናቸው ን ሊ ጐበኙ አልቻለ ም
ድንበር የ ማካለሉ ውሳኔ በ ገለልተኛ የ ድንበር ኮሚሽን አማካኝነት በ ሚቀጥለው ወር ከ ሄግ እንደሚ ገለጽ አመልክ ቷል	ችግር የ ማእከላዊ ውሳኔ ን በ ተመለከተ ና የ ድንበር ኮሚሽን አባላት በ ተመለከተ ለ ው ከ ሄግ እንደሚደረግት አስረድ ቷል
ገጀራ ው ተይዞ ምስክሮች ቀርበው የ ፍርድ ሂደቱ ን ማከናወን ሲ ችሉ ፋይሉ ን ዘግ ተው እንዲ መለስ ተደርጓል	ሊቨርፑል ተይዞ ስከት ከው የ ፍርድ ሂደቱ ን ማክሰኞ ውን ሲሉ ከፊሉ ን ዘግተው እንዲ መለስ ተደርጓል
ከ አዲስ አባ ወደ ጅማ በሚ ወስደው መንገድ ሀምሳ አምስት ኪሎ ሜትር በ ምትገኘው በ ተጂ ከተማ አካባቢ ብዙ ሰዎች ሞ ተዋል ተ ብሏል	ከ አዲስ አበባ ወደ ድማ በሚ ወስደው መንገድ አንድ አምስት መቶ ዶላር በምት ገኝው በፊት ከ ከተማ አካባቢ በ ሶስት ሰዎች መካከል ተ ብሏል
አጋፋሪ ዎቻቸው ባ አዳ ኑም አቋማቸው ለ ነርሱ ሀር ቶ ና ሙ ቡቶ ከ ሰጡት ድጋፍ አይ ለይም	ጺ ማቸው በ አያያዝ ም አብሮማቸው ለ እነርሱ አርፎ ና አሞተው ከ ስልጣን ድጋፍ አይ መለከት ም
በሌላ በኩል ሁለቱ ኤርትራ ና ኢትዮጵያ የገ ዟቸው አውሮኘላኖ ች ከ አንዱ ዋ ና ከተማ ወደ ሌላው የ መብረር አቅም እንዳ ላቸው በ ዚሁ ዘገባ ተረጋግጧል	በሌላ በኩል ውጤቱ ኤርትራ ና የ ኢትዮጵያ ፉትቦል አውሮፕላኖች ካምፕ ዋ ና ከተማዋ ወደ ሊቢያ መባረር እንዳ ላቸው በ በዚህ ዘገባ ያስረዳ ሉ
በዚህ እንደ ተስማሙ ለማ ን ት ሰጥ ለማ ን ሲ ባል ለዚህ ማ ካሳ አለ አይደል አንዴ የ ኮ ሶ ሻጭ ልጅ የሚ ል ሀሳብ ተሰማ	በዚህ ደግሞ ለ ማረጋጋት ለማ ን ሲ ባል ለዚህ ማቃሴ ላይ ግን እንደ ኮል ሊግ የሚ ል ሀሳብ ተሰማ
ዛሬ ም ይህ ጽሁፍ እስከ ተጻፈ በት ድረስ ከ አንድ ሺ ዘጠኝ መቶ አርባ አመተ ምህረት ጀምሮ በ ዚሁ ከተማ በ መኖር ላይ ይገኛሉ	ጋር የሚ ሶ ት እስከዛሬ በት ድረስ ከ አንድ ሺ ዘጠኝ መቶ አርባ አመት ን ጀምሮ በ ዚሁ ከተማ ከተማ በመቶ ዎች ላይ ይገኛሉ
እስከ አንድ ሺ ዘጠኝ መቶ ስልሳ ስድስት ድርስ በ ኢትዮጵያ የነበረው መንግስታዊ ስርአት የ ሲ ሶ ስርአት በመ ባል የሚ ታውቅ እንደ ነበር ይታወሳ ል	ሶስት አንድ ሺ ዘጠኝ መቶ ስልሳ ስድስት ድረስ በ ኢትዮጵያ የሚኖሩ መንግስታዊ ስርአት የሴፍ ስርአት በ መቀበል የሚ ታወቅ እንደ ነበር ይታወሳ ል
በዚህ ክልል ለ በርካታ ዜጐች ም የስራ እድል ይ ፈጥራል የሚሉ ሲ ኖሩ በተለይ ለ ሶማሊያውያን እድሉ ሰፊ እንደሆነ ተጠቅ ሷል	በዚህ ክልል በ ህገወጥ ከተሞች ም የስራ እድል ጄኔራል የሚ ኖሩ በተለይ ለ ጠቅላላውያን ገብተው እንደሆነ ተጠቅ ሷል
ጅቡቲ ይህን ለምን እንደ ፈጸመች የ ጅቡቲ የውጭ ጉዳይ ሚኒስተር ሲናገሩ ለ ሀገራችን ሰላም ና መረጋጋት እርምጃ ችን ፍትሀዊ ነው ብለዋል	ጅቡቲ የ ን ለምን እንደ ገለጸው የ ጅቡቲ የውጭ ጉዳይ ሚኒስትር ሲናገሩ ለ ሀገራችን ሰላም ና መረዳት እርምጃ ችንን ሰጥቶ ነው ብለዋል
ለ ዜጐቻቸው የተደላደለ ኑሮ ፈጥረው ከ ተለያዩ ሀገሮች የ መጡ ስደተኞች ን ያስተናግ ዳሉ በ ማለት በልዩ አይ ን እንመለከታ ቸው ይሆናል	ለ ህዝባቸው የ ተሟላ እቅድው ከ ተለያዩ ሀገሮች የ መጡ ስደተኞች ን ያመጣሉ በ ማለት በል አይ ን ን ይመለከታቸው ናል
ያላሰላሰል ነው ጉዳይ በ አምባገነኖች ና በ ጥጋበኞች ጦስ በሚ ቀጣጠለ ው እሳት የሚ ነድደው የዚህ ዘመን የ ሀገራችን ጭቁን መሆኑን ነው	ቤዛ ጐረ መሰ መሰለኝ መሰለች ና በ ቅርብ አልጀርስ በሚ ወስደው ሳምንት የሚ መጣው የኤርትራ ዘመን ሀገራችን ሽሙ ነው
የ ኬንያው ፕሬዝዳንት ከ ኢትዮጵያ ባለስልጣናት ጋር በ ኬንያ ና በ ኢትዮጵያ ድንበር ሞያሌ አካባቢ በተነሳ ው ግጭት እንደ መከሩ ዲፕሎማቲክ ምንጮች ጠቁ መዋል	የ ኬንያ ፕሬዝዳንት ፕሬዚዳንት ከ ኢትዮጵያ ባለስልጣናት ጋር በ ኬንያ ና በ ኢትዮጵያ ድንበር እያ ለ አካባቢ በ እረፍት እንደ ነበረ ዲፕሎማቲክ ምንጮች ጠቁ መዋል
ጄኔራሉ አያይዘው ም በ ትናንቱ የ አየር ጥቃት በ ኤርፖርት አካባቢ የሚገኝ አንድ ግዙፍ የ ጦር መሳሪያ መጋዘን መጋየቱን ም አብራር ተዋል	ጄኔራሉ አያይዘው በ እለቱ የ እርቅ እውቀት የ ፕሮፌሰር ታዬ የሚገኙ አንድ ገንዘብ የ ጦር መሳሪያ መሳሪያ መደሰታቸው ን አመልክ ቷል
በ አስተያየቱ ትስማማ ለህ ተብሎ ሲ ጠየቅ አሰልጣኝ ሀጐስ ይህ አይነት አጋጣሚ በ መላው አለም ላይ ሲ ከሰት ተስተ ው ሏል በ ማለት መልሷ ል	ፕሬዚዳንቱ ትንሽ ማለት ተብሎ ትልቅ አሰልጣኝ ቶሎ ት ሊያ ጠጣ በርን ለ አለም ላይ ሲደርስተፈው ነበር በ ማለት መልሷ ል
በ ወቅቱ የ ጠላት ሰራዊት የ ጫኑ የሚገኙ ባቸውን ከ ሰላሳ በላይ የ ጠላት መኪናዎች ን አጋይ ተዋል	በ ወቅቱ የ ፍትህ ሰራዊት የ ጫኑ የሚሰሩ ባቸውን ከ ሰላሳ በላይ የ ህጻናት ን ጥያቄዎች ን አመልክ ተዋል
እነኚህ ን በ መላው የ ኢትዮጵያ ህዝብ ስ ም ሰማእት የሆኑት ን አርበኛ ተጋድሎ አቸውን ለ ማሳነስ የታቀደ ሴራ ነው በሚል ቅሬታ ውን ገልጧል	እነኚህ በ መላው ኢትዮጵያ ን ግብጽ ን አስመልክቶ የሆኑት ን በሚ ጠቀምዳቸው ለ ማሳፍ የ ታጋንዳ ሲሆን የ ንግድ ባንክ ቅሬታ ውን አመልክ ቷል
ሸምጋይ ቡድኑ እንደሚ ሰበሰብ ያስታወቁ ት የ ወቅቱ የ አፍሪካ አንድነት ድርጅት ሊቀመንበር ና የ ቡርኪናፋሶ ፕሬዝዳንት የሆኑት ብሌዝ ካምፓ ኦሬ ናቸው	ሼድ ቡድኑ ን እንደሚደርስ የ ሚያደርጉት የ ዶክተሩ የ አፍሪካ ና የ ሪፐብሊክ ና የ ጅቡቲ ን ፓስ ፕሬዚዳንት የሆኑት ዴስ ካምፕ ቦሌ ናቸው
የሚሉት በ አጭሩ ደረጀ ዴሬሳ ከ ልጅነት እስከ እውቀት በ ቃኝ ታ ከተ ኝ ሳይ ሉ ለ ኢትዮጵያ ሲ ለፉ ህይወታቸው ያለፈ አርበኛ ናቸው የሚ ል አይነት ነው	ይልቁን ባ ሰራጨው ሬት ሳካለከት ከ እውቀት በ ካኝ ታኝ ሲ ሄዱ ለ ኢትዮጵያ የ ሲ ነጻነታቸው ን ፍቅር በ እኛ ና የሚ ልነት ነው
ባለፈው ቅዳሜ ፕሬዝዳንት ኢሳያስ በ ተገኙ በት የ ተማረከ ውን አብራሪ ኤርትራ ለ ህዝቧ በ ማሳየት ህዝብ ለ ማስደሰት ሙከራ ማድረጓ ን የተለያዩ የ ዜና ምንጮች አሳው ቀዋል	ባለፉት ቅዳሜ ፕሬዝዳንት ነጋስ በ ተገኙ በት የ ተካሄደው ን ማህበር የኤርትራ ለ ህዝባዊ ማስ ክስ ለ መስጠት ሙከራ ተግባራዊ የተለያዩ የ ዜና ምንጮች ጠቁ መዋል
ይህን ጉዳይ አስመልክቶ በተ ገመገሙ በት ወቅት ከ ሰራተኞቹ ጥያቄ ቀርቦ ላቸው ሲ መልሱ ገንዘቡ እንዲ ሰጠኝ እኔ ጥያቄ አላ ቀረብኩ ም ብለዋል	ይህንን ጉዳይ አመልክቶ በ ቅድሚያሙ በት ወቅት ከ አራት ሰአት እያ የ ቆዩ ናቸው ሲ መልሶ ገንዘቡ እንዲ ያስችኝ ም ን ጥያቄ ማድረግ ም ብለዋል
እ ዚሁ ሊ ያደቅ ቃቸው የሚ ፈልጋቸው ን ሰዎች ካልሆነ በ ቀር ለ ጠየቀ ሁሉ ፓስፖርት ም ቪዛ ም ይሰጣል	በዚህ እያ ለ እያንዳንዳቸው ይህንኑ ን ሰዎች አልነበሩ ን በ ቀላሉ ሁሉ አዲስ ክስተት ን ላታል
የ ሟች ቤተሰቦች መርዶ ው እስከ አሁን የተደበቀ ብን አቅም የ ላቸውም ም ን ያደርጋሉ ከሚ ል ንቀት የመነጨ እንደሆነ ም በ ማማረር ይናገራሉ	የ ማሽሽ ሰዎች መርድ ውስጥ አሁን ት ደክመብን አቅም ያ ላቸው ም ን ያህል ከሚ ጥፍ የ ነዳጅሆን ም በ ማህበር ይናገራሉ
የቀ ሯት ን መንትያ ልጆች በ ትካዜ ተመለከተ ቻቸው እነሱ ንም እንደምት ቀብር ከ አይኗ ላይ ከሚ ነበበው ተስፋ መቁረጥ መረዳት ይቻላል	የ ረማት ነት ለ ሌሎች በ ትግራይ የተ ወሰዱትቸው እነርሱ ም እንደምት ቀርር ከ አንዋ ላይ ከ ረቅቡእኖ መውጣት መረዳት ተችሏል
ጠበቆቻቸው የ ጊዜ ቀጠሮው ን በ ጥብቅ ተቃወሙ በተለይ አቶ ቢተው በላይ በ እልህ ከ ተናገሩት ውስጥ አን ኳር አንኳ ሩን ከዚህ በታች አቅርበ ነዋል	ችግሮቻቸው የ ሚከተለው ን በ ቅርብ ተቃውሞው በ መጀመሪያ አቶ ቆይተው ላይ በ እለቅ ከ ተናገሩት ት ውስጥ አንዷ እንኳ ን ህዝብ በታች ገልጸው ልናል
ዘገባው ከዚህ በ ተጨማሪ በ ታዳጊ አገሮች ያለውን የ ድህነት መጠን በ ተመለከተ ፍንጮች ን ይፋ አድርጓል	ዘገባው ከዚህ በ ተጨማሪ በ ታንዛኒያ አገሮች ያለውን የ ደህንነት መምታት ተከ ፍንጮች ን ይፋ ል
አራት ኪሎ ና አምስት ኪሎ ፋኩሊቲ ዎችን ቃኝ ተው ሽቅብ በ መውጣት በ ስድስት ኪሎ ዩኒቨርስቲ አልፈው ከ ወጡ በኋላ ዞረው ይመለሳሉ	አራት ኪሎ ና አምስት ኪሎ ኬክ ክፍሎች ን ታግደ ው ጭቅ በ መውጣት በ ስድስት ቢሊዮን ብር አውጥ ቷል
ግንኙነታችን ደግሞ ወደ ሞቀ ሁኔታ ተመል ሷል ብለዋል አንድ ከፍተኛ የ ጅቡቲ ባለስልጣን ለ ኢሪን	እዳ ችን ደግሞ ወደ ሞቀ ው ሁኔታ ተ መንሳ ለ አንድ ከፍተኛ በውጭ ዜጐች ባለስልጣናት ለ ይ ለዋል
የ አልበሽር መንግስት ከዚህ በኋላ የኤርትራ ሉአላዊነት የሚ ጻረር ና የ ባለ ስልጣናቱ ን ስብእና ከሚ ነካ ተግባር መቆጠብ እንደሚ ኖርበት ገልጸዋል	የ አልሽር መንግስት ከዚህ በላይ የኤርትራ ታላላቅ ግንኙነት የሚ መለከት ና የ ባለ ሀብቱ ን ስ ም ና ከቃ ተግባር መልኩ እንደሚኖር በት ገልጸዋል
ም ን ጊዜ ም የ ሪፖርተር እና የ ኤም ሲ ሲ ማህበረሰብ አባላት ለ ፕሮጀክቶቹ ስኬታማነት ከ ሀይሌ ና ከ አጋሮቹ ጐን ናቸው	ም ን እንግሊዝ ም የ ፕሮፌሰር እና የ ሚስተር ማህበር አባላት ለ ተጨዋቾቹ ቤተ ክህነት ከ ሀይሌ ና ከ ታገዱቹ ጋር ናቸው
በ ህግ መድረክ የ ተደረገው ትግል ፍትህ ተገኘበት ም አልተገኘ በት ም ወጪ የሚደረግ በት ነው	በ ህግ የተያዙት የ ተደረገው እድል ዳይሬክተር ተገኙ በትን ማክሰኞ በት ም ውጪ የሚደረግ በት ናቸው
በዚህ ውጊያ የ ኢትዮጵያ ተዋጊ ጄቶች እንዲሁም የ ውጊያ ሄሊኮፕተሮች መሳተፋቸው ንም መግለጫው አመልክ ቷል	በዚህ ውጊያ የ ኢትዮጵያ ተዋጊ ጄቶች እንዲሁም የ ውጊያ ሄሊኮፍተሮች መጫቸው ንም መግለጫው አመልክ ቷል
ግን ዜጐቻችን ን እንዲሰጡ ን ብን ጠይቅ ም ሊሰጡ ን አልቻሉም በ ማለት ለ ቪኦኤ ዋ ዘጋቢ ገልጸዋል	ግን ችሎታችን ን እንዲሰጡ ን ቢ ጠየቅ ም የሚ ችለው ን ነገር በ ማየት ለ ዜሮ አሸን ፏል
አመዛኙ እርስ በራሱ ሲ ጨራረስ ጆሮ ዳ ባ ልበስ ብሎ ማየት የ ብልህ መሪዎች አስተሳሰብ ሊሆን አይችልም	አሰልጣኙ ርእስ በ እግር ኳስ ተጫዋች ወደ ባደረገ ው ብሎ የ ማየት የ ብሄራዊ መሪዎች አስቸጋሪ ሊሆን የቻለ ም
ዛሬ አሜሪካ ተቆጥቶ የ አፍሪካ መንግስታት በ አስታራቂ ነት ተ ሰይመው ጊዜያዊ የ ተኩስ ማቆም ስምምነት ላይ መድረስ መፍትሄ አይሆን ም	ዛሬ የ አሜሪካ ወጥ ቶቶ የ አፍሪካ ን መንግስታት በ አስተዳደር ነት ተፈሪ የ ዲግሪ የ ተኩስ አቁም ስምምነት ላይ መግዛት መብት አይ ሆኑ ም
የ አለም የ ምግብ ፕሮግራም ብቻ ውን ወደ ሰላሳ ሺ ቶን እህል መርዳቱ ተ ገልጿ ል	የ አለም የ ምግብ ክለብ ብቻ ውን ም ወደ ሰላሳ ሺህ ቶን ን ያህል ን አመልክቶ ተ ገልጿ ል
ኮሎኔል መንግስቱ ይህንን ግ ለት ለ አብዮቱ ቢያ ውሉት ሲሉ እኔ እስከ ማውቀው በቂ ምክንያት ነበራቸው	ኮሎኔል መንግስቱ ይህንን እ ለት ለ ራዲዮ ኢትዮፕያ ት ሲሉ እኔ ከ ማውጣት በት ምክንያት ነበረ
በ ዴን ቨር ኮሎ ራዶ አሜሪካ በ ቅርቡ በ ተካሄደው በ ኢንዱስትሪ እድገት በመ ጠቁ የ ስምንት አገሮች ስብሰባ ላይ የተወሰነ ውም ከዚህ ውጭ አልነበረ ም	በ ደንብ ኮሎ ዋን በ አሜሪካ በ ቅርቡ በ ተካሄደው በ ስፔን ገት ነቅ የ ስምንት ወታደሮች የ እስራኤል ን እየ ስምምነኑ ም ከዚህ ብቻ ነው
በዚህ ላይ ዊአህ ተደራ ቢ አጥቂ ሆኖ በ መጫወት ላይ በመሆኑ እየ ተማረረ ነው	በዚህ ላይ እምነት የ ያዙት ሲ ሆኑ በ ጯ ት ላይ በ ሙሉ እየተካሄደ ነው
የ ኢትዮጵያ ባለስልጣኖች የ ዛል አምበሳ ከተማ ክፉ ኛ በ ኤርትራዊያን ከባድ መሳሪዎች መደብ ደ ቧን አ መለከቱ	የ ኢትዮጵያ ባለስልጣኖች ጀርመን ገዳ ከተማ ክፍል ያ በ ኤርትራውያን ከባድ መሳሪያ ዎች መጠብ ደግሞ አ መለከትጡ
በ አጠቃላይ በ እኔ ና በ ዋናው ጸሀፊው መካከል አለ መግባባት ሲ ከሰት በ መሀላችን ጣልቃ የሚገባ ወገን ባለ መኖሩ ችግሩ ሊ ባባስ ችሏል	በ አጠቃላይ ድል ና በ ዋ ና ስርአት መካከል አለ ው
ፕሬዝዳንቱ በ ዚሁ ንግግራቸው ኢትዮጵያ የ ጅቡቲ የ ህይወት መስመር ብቻ ሳት ሆን የ ወደቡ ሰማኒያ ከ መቶ ብቸኛ ተጠቃሚ መሆኗ ንም ጨምረው አስረድ ተዋል	ፕሬዚዳንቱ በ በዚህ እራቸው ኢትዮጵያ ጅቡቲ የ ህይወት ብቻ ሳቢያ ውን የ ደቡብ ሶማሊያ ን ከ አመት ብቸ ት ትንሽ መሆን ንም ጀምሮ አስረድ ተዋል
ድርጅቱ በ ሚላን ለ ን ደነ ና ኒውዮርክ ከተሞች ጽፈት ቤቶች ሲ ኖሩት ከዚህ ሌላ የ ጣልያን እግር ኳስ ሊግ ን ይቆጣ ጠራል	ድርጅቱ በ እያንዳንዱ ን ና የ ወቅት ከተማስ ውስጥ ጽፈት ቤቶች ስ ጀምሩ ከ ተለያዩ የ ጣሊያን እግር ኳስ ሊግ ይታወ ቃል
እንዲያ ውም ድርጊቱ ኢትዮጵያ በ ኤርትራ ላይ ሙሉ ወረራ ለማድረግ እንደ ምክንያት የ ም ትጠቀምበት ነው ሲሉ ኮን ነዋል	እንዲያ ውም ድርጅቱ ኢትዮጵያ በ ኤርትራ ላይ ያለውን ወረራ ለ መታደግ እንደ ምክንያት ትምህርት ጠቀምበት ና ሲሉ ኮን ነዋል
ለ ቅሳቸው ና ግርግሩ ሲ በርድ ለ ቀን ወጣ ን ይህ ነው እውነታው እንጂ ዘግ የ ት ብለን የ ወጣ ነው በ ስብሰባው መቀ ጠን ፈልገ ን አይደለም	ለ እሷቸው ና አገልግሎት ሸጥ ለቃት ይህ ይነ ው እውነታውረረ ት ብለን በርካታ ነው በ ስብሰባው መጠን ገልጸ ን አይደለም
ወደ ትውልድ መንደራቸው የሚከዱት ን ማደን ቀርቶ ለ ስምንተኛው ዙር የ ሳ ዋ ስልጠና ተ መልማይ ለ ማግኘት መቸገሩ ተ ዘግ ቧል	ወደ ሁለቱ ክለቦቻቸው የሚ ደረጉ ን ን ማዳን ቀርቶ ለ ስምንተኛው ዞር የ ሳ ዋ ስልጠና ተ መልማ ለ ማግኘት መደሰሩ ተ ዘግ ቧል
ምክር ቤቱ ከዚህ ቀደም የ ቀረበለት ን የ ኦዲተር ሪፖርት መሰረት አድርጐ ም ን እርምጃ ወሰደ በ ማለት ለ አፈ ጉባኤው ጥያቄ ቀርቧል	ምክር ቤቱ ከዚህ ጋር ን የ ጋላ መልእክቶች ን የ ኦዲት ሪፖርት መሰረት ም ንም እርምጃው ን ተግባራዊ ለማድረግ ጥያቄ ዘግ ቧል
ቀሪዎቹ አስፈጻሚው አካል በ ህግ ከ ተሰጠው ስልጣን ሳይ ዘል የሚያ ከ ናውናቸው ተግባሮች ይሆናሉ	ጋዜጦቹ አብዛኛው አአድ በ እቅድ ተጫውተ ው ስልጣን ሳይ ዘል የሚ ያስችውናቸው ተግባሮች አሉ
ቀደም ሲል የ ጠቀስኳቸው ህመሙ የ ጸና ባቸው ወደ አራት መቶ የሚ ጠጉ ተማሪዎች ከ ሌሎች ተለይተው የሚ ተኙበት ስፍራ ተዘጋጅቶ ላቸዋል	ቀደም ሲል ለ ልጆቻቸው መልስ ና ባቸው አራት ቅዳሜ የሚ ጠጉ ተማሪዎች ከልሉ ተጠያቂ ው የሚታይ በት ተጽእኖ በታል
ከ ሟ ቾቹ ጋር የነበሩ ሁለት ታጣቂዎች በ ሰላም እጃቸው ን መስጠታቸው ንም የ ፖሊስ መግለጫው አክሎ ገልጿ ል	ዲፕሎማቶቹ ጋር የነበሩ ው ፓርቲዎች በ ሰላሙቸው ን መስጠታቸው ንም የ ፖሊስ መግለጫው አክሎ ገልጿ ል
ኦነግ ለ ሁለት ተከፍሎ መስማማት የ ማይችልበት ደረጃ ላይ መድረሱ ን የ አመራር አባላቱ ገለጹ	ኦነግ ለ ሁለት ቀጥሎ ም እንዳሉት የማይ ታወቅ ለት ደረጃ ላይ መከስ ን የ አምር አመቱ ገለጹ
መጀመሪያ ነገር ይህንን ህገ መንግስት መቀበል ማለት የ ወያኔ ን የፖለቲካ ፕሮግራም መቀበል ማለት ይሆናል	መጀመሪያ ያ ነገር ይህንን ም ህገ መንግስት መቀበል አለ ማለት ወያኔ የፖለቲካ ና ፕሮፓጋንዳ መቀበል አለ ማለት ነው
ከዚህ ጋር ለ ሰብአዊ አገልግሎት መሰለ ፏ ም ውጤታማ መሆኗ ም አድናቆት ን አትርፎ ላታል	ከዚህ ጋር ለ ሰብአዊ መብት መሳሪያ
እንደ ኦፊሴላዊ ው መግለጫ ከሆነ ሊቢያ ና ኤርትራ በ ኢኮኖሚ ና በ ባህል ጉዳዮች ላይ ከ ጋራ ስምምነት ላይ ደርሰዋል	እንደ ሪፖርተራ ው መግለጫ ከሆነ ሊቢያ ና ኤርትራ በ ኢኮኖሚ ና በኩል ጉዳይ ላይ ከ ጋራ ስ ምላሽ ደርሰዋል
ምርጫው በ ተጠናቀቀ በ ሰላሳ ቀናት ውስጥ አዲሱ የ ከተማው ምክር ቤት ስራው ን ይ ጀምራል	ምርጥ በ ህገወጥ ሰላሳ ቀናት ውስጥ አዲሱ የ ከተማው ምክር ቤት ስራው ን ጀመሩ
አንድ ኢትዮጵያዊ ፕሮፌሰር ደግሞ ረጋ ብለን ስናስ በ ው ጦርነቱ ን ያስከተለው ሁለቱ ም መሪዎች የ ተከተሉት የፖለቲካ መስመር ነው ይላሉ	አንድ ኢትዮጵያዊ የ ፕሮፌሰር ደግሞ አደገር ለ ስ ና ስበው ጦርነቱ ን ያስረዳ ው ሁለቱ ን መሪዎች የ ፕሮሉ ት የፖለቲካ ተንታኞች አሉ
በዚህ ም መግባት አት ችልም ሲ ባል የ ሪፖርተር ጋዜጣ ዋ ና አዘጋጅ ያለምን ም ጥያቄ ተ ፈትሸው ሊ ገቡ መቻላቸው ጠቁ ሟል	በዚህ ም መግዛትቼ ም ሲ ባል የ ፕሮፌሰር ሪታ ዋ ና ተቋም የ ለ ም ጥያቄ የ ተባበሩት መንግስታት ሊ ቋቋም ያ ላቸው ተጠቁ ሟል
በ ጀርመን የሚገኙ ወጣቶች ም ለ ብሄራዊ ቡድን እድል ስለማይ ሰጣቸው ዜግነታቸው ን እየ ለወጡ ይገኛሉ	በ ጀርመን የሚገኙ ወጣቶች ም ለ ብሄራዊ ቡድን ችግር ለ ማሰ ቸው ችሎታቸው ን የ ለውጡ ይገኛሉ
አያይዞ ም በ ምስራቅ መምህራን ማሰልጠኛ ኮሌጅ ሰባት የ ኦሮምያ ተማሪዎች ከ ትምህርት ገበታ ቸው መባረራቸው ንም አውግዘ ዋል	አሱ ን በ ምስራቅ ዞን ማስፈጸሚያ ሁል ሰባት የ ኦሮሚያ ተማሪዎች ከ ትምህርት ከ ገበታ ቸው መባረራቸው ንም ገልጿ ል
ዛሬ ከ ሌይስተር ጋራ ከ ተጫወተ በኋላ ሳምንት ከ ቸል ሲ የሚያደርገው የ ቡድኑ ደረጃ የሚ ያመለክት ይሆናል	ዛሬ ጠቅላይ ሚንስትር መለስ ከ ተጀመረ በኋላ ሳምንት ክትት የሚ ደረገው የ ቡድኑ ደረጃ የሚ ያመለክት ይሆናል
በ ሀጅ ና ኡምራ ሙስሊሞች ሀይማኖታዊ ግዴታ ቸውን ለ መፈጸም በዚህ ችግር አበሳ ውስጥ ገብ ተዋል	በሀ ና ምናልባት የ ቴክኖሎጂታዊ ውጤታቸው ን ለ መሸም በፊት ችግር በ ሶስት ውስጥ ገብ ቷል
ዛፎች ትልልቅ ድንጋዮች ወይም ወንዝ ካለ የ ኢትዮጵያ ድንበር ነው ይባላል ሲሉ ሰምቻ ቸዋለሁ	ዛዎቹ ትልቅ ተጨዋች ወይም ፕሬዚዳንት ካለ የ ኢትዮጵያ ን ድንበር ነው የ ሚባለው ሲሉ
ለ ጠቅለይ ሚንስትር መለስ ዜናዊ ያስተላለፉ ትን ደብዳቤ ሙሉ ቃል ከዚህ ቀጥሎ እና ቀር ባለ ን	ለ ጠቅላይ ሚኒስቴር መለስ ዜናዊ ነው ያመጣ ን
ሁላችን ም እንደ ተመኘ ነው ሙሉ በ ሙሉ መደምሰስ እንኳ ን ባይደርስ በት ም ሰራዊቱ በጣም ከባድ ጉዳት ና አሳፋሪ ሽንፈት ደርሶ በታል	ሁላችን ም እንደ ተኙ ነው ሙሉ በ ሙሉ መጠን ስ ም ቆላደርስ በት ም ጸረ መብት ጸረ ጉዳት ና ጸረ ፓርቲዎች ደርሶ በታል
ርእሰ አንቀጹ በ መቀጠል ም ነጻ ጋዜጦች የ ረቀቀ ማስፈራሪያ ና ወከባ ም ይካሄድ ባቸዋል	እርስዎ አንድ ካሱ በ ምክትል ነጻ ድርጅቶች የ ጠገቅ አስመራ ንና እ ከ ው ይታዊ ቸዋል
ፋና ዲሞክራሲ የ ተሰኘው ና የ እፎይታ ጋዜጣ ና መጽሄት አሳታሚ ድርጅት በ ይፋ ተዘግቶ ሰራተኞች መበተናቸው ታወቀ	ጸረ ዴሞክራሲረኛው ና የ ፊቱ አት ና መለስ ዜናዊ አሳ ን ድርጅት በ ይፋፋ ሰጥቶ ሰራተኞች መቀበልቸው ታወቀ
ሻእቢያ አ ከ ሸፍ ኳቸው የሚ ላቸው ስምንቱ የ ደርግ የ ዘመቻ ዙ ሮች መ ና ሆነው የ ቀሩት በ ወያኔ ተዋጊዎች መስዋእትነት እንደሆነ ይነገራ ል	ሻእቢያ አ ጶች የሚ ባሉ ትን ስምንቱ እያደረጉ ዘመን ተጨዋቾች ና አሁን የ ገለጹት የ ወያኔ ተዋጊዎች መስራት ነት እንደሆነ ይነገራ ል
የምና ቀርበው ሀሳብ በ ኢትዮጵያ ፉትቦል ፌዴሬሽን ዘንድ ተቀባይነት ያገኛ ል ብለን እንገ ም ታለን	ያ ቀረቡ ሀሳብ በ ኢትዮጵያ ፉትቦል ኮንፌዴሬሽን ዘንድ ን ተቀባይነት ያመጣሉ ን እንወዳ ለ ን
ከ ቁልቢ ወደ ሀረር ተ ወስደው መታሰራቸው ከ መታወቁ በስተቀር ይህ ዜና እስከ ተጠናከረ በት ጊዜ ድረስ ም ንም አይነት ለውጥ አለመኖሩ ን ውስጥ አዋቂ ዎቹ ገልጸዋል	ከ ልጅው ወደፊትር ውስጥ በ መግዛት ከ መጐስ ክልል የ ዜና አስተዳደር በት ጊዜ ም ንም አይነት ባለመሩ ውስጥ አዋቂዎች ገልጸዋል
ወደ አስመራ ከ ገሰገስን ከቶ ውንም አለም አቀፍ ማእቀብ ይጣል ባቸው የሚ ል ውሳኔ ይሰጥ ብናል	ወደ አስመራ ከበሰገስ ን ከቶ ውንም አለም አቀፍ ማደራጀት ይ ባቸው የ ለ ም
ዘ ታይም ዘጋቢ እንደ ዘገበው ትልቁ የ ምግብ ማመላለስ ተግባር ወደ ዲ ና ን የ ተደረገው ከ ሀምሳ ቀናት በፊት ነበር	ለ ትክክለኛ እንደ ዘገበው ትልቁ የ ምግብ መንግስት ተግባር ደግሞ የ ተደረገውው ከ ሀምሳ ቀናት ተጨማሪ ነበር
ይህንን በ ተመለከተ ከውጭ ጉዳይ ሚኒስቴር ማብራሪያ ለ ማግኘት ያደረገው ጥረት አልተሳካ ም	ይህንን በ ተመለከተ ከ አካባቢዎች ጉዳይ ሚኒስትር ማህበር ለ ማቋቋም የ ለ ባቸውም
የ ቢራ ው ኢንዱስትሪ ግን የ ታክስ ቅነሳ ቢደረግ ለትም ም ንም አይነት የ ዋጋ ለውጥ ለ ደንበኞቹ አላደረገ ም	የ ብሄራዊ መንግስት ቢሊዮን የ ተኩስ አቁ ሊደረግ ለት ም ም ን አይነት ያሟላ ት ለ መሸቹ አላልኩ ም
አምላክ መልአክ ትን ሲ ፈጥር የ መልአክ ት አለቃ ሆኖ የ ተፈጠረው አሁን ሳጥናኤል የምን ለ ው ከ ይ ሲ ነበር	አንቶኒክ መሀት ን ሲ ጀምርር የ ሚያደርጉት አለቃ ሆኑ የተ ገለጸልንው አሁን ሰአት ና ይፋ ነው ከ ይዤ ነበር
የ ሁልጊዜ የ ይህ ይ ሟላ ልን ጥያቄ ዶክተር መኮንን ና የ ቡድን መሪው ናዝሬት በ ነበሩት ጊዜ አልታየ ም	ሂር ጶ የሚለው የ ኦሮምያ ን ጥያቄ ዶክተር መቀበል ና የ ቡድን መሪም ና ናዝሬት በ ነበሩት ጥቂት አልቀረ ም
ቡድኑ በ እንግሊዝ ካሉ ት ክለቦች በ አካል ብቃቱ በኩል የ ተዋጣለት ና ዲስፕሊን ን መርሆ ያደረገ እንደ ነበር ይነገራ ል	ቡቡ በ ቅዱስ ጳውሎስ ክለቦች በቃል ውጤቱ በ መገኘቱ ጨዋታ ለ ት ና አዲስ ክልል ን መርጬ እንደ ነበር ይነገራ ል
በዚህ ም ኢትዮጵያ ን የተሻለ ች ሀገር ለማድረግ በሚ ደረገው ጥረት የበኩሉ ን አስተዋጽኦ ያደርጋል ብዬ አምናለሁ	በዚህ ም ኢትዮጵያ ን የተነሱ ሀገር ልማት ማድረግ በሚ ደረገው ጥረት የ በ በኩላቸው ን አስተዋጽኦ የሚያደርገው ቃል ብዬ አ ና ለ ው
ከዚህ ም በ ተጨማሪ ወጣት ተጨዋቾች ን በ ማሰባሰብ ለወደፊቱ ሊ ጠናከሩ በት የሚችሉ በትን መንገድ አመቻች ቷል	ከዚህ ም በ ተጨማሪ ወጣት ተጫዋቾች ን ለ ማዘጋጀት
ኢትዮጵያ ሰላም ፈላጊ በ መምሰል እያደረገች ያለችው ን ደባ ለ ማምከን ና ሶስተኛው ን ዙር ወረራ ለ መደምሰስ ዝግጁ ነን ሲሉ ም ተደም ጠዋል	ኢትዮጵያ ሱዳን ስደተኞች በ መያዝ እ ያባረረ ች ያሉት ን ለ ማጠናከር ና ሶስተኛው ዙር ወደ ለ መሸሰስጁ ን ሲሉ ተመልክተ ጠዋል
የ አካባቢው ከፍተኛ ባላባት ማ ላክ ሻ ወሪ እንዳስ ታወቁት የ አውሮፕላን ማረፊያ ው ከባድ አውሮፕላን ማሳረፍ ይችላል ተ ብሏል	ያደጉ አካባቢው ከፍተኛ ባለ አባላት ሽያጭ እንዳስ ታወቁ ት የ አውሮፕላን ማረፊያ ው ከ ጃፓን ማህበር ጫና ተ ብሏል
ቪዮ ሪ ለ አትሌቲኮ በ ስፔን ሊጋ ና በ ማህበረሰቡ ዋንጫ ሊስት ውስጥ ተ መዝግቧል	ሪሪ ሪል ና ቴክኒክ ኮንፌዴሬሽን ልድረስ ና በ ማህበራዊ ባንክ ታሊክ ውስጥ ተ ዘግ ቧል
አውሮፕላኑ እቃ ጫ ኝ ሲሆን በ በረራው ላይ ስድስት የ አየር መንገድ ሰራተኞች ን አሳፍ ሮ ነበር	አውሮፕላኑ ድጋፍ ሲሆን በትናንትናው ላይ ስድስት የ አየር መንገድ ሰራተኞች ን አሳረው ነበር
በ አለም ላይ ያሉ የ የ አገሩ መረጃዎች ካ ሏቸው የ መረጃ ምንጮች ውስጥ አንዱ የ ፕሬስ ውጤት ነው	ባድመ ላይ እያሉ የ ማህበሩ መረጃዎች ካ ሏቸው የ መረጃ ምንጮች ውስጥ አንዱ የ ፕሬስ ውጤት ነው
አርቲስት ስለሺ ህ በ ፖለቲካ ውስጥ ተሳትፎ ያ ላቸው ግለሰቦች በ ሀላፊነት መቀመጥ እንደሌለ ባቸውም ጠቁ ሟል	ሀሬት ስለዚህ በ በኩላቸው ውስጥ ተሳትፎ ያ ላቸው ዳኞች ባለ ሀብት መልኩጥ እንደሌለ ባቸው ም ተጠቁ ሟል
ኢትዮጵያ ጦርነቱ ን በድል ለ መወጣት ወሳኙ ና ብቸኛ ው ጊዜ ዋ አሁን ነው	ኢትዮጵያ ጦርነቱ ን በግል ለ ማጥፋት በሰ ና ብቸኛ ው ጫና አሁን ነው
ካሁን የተሻለ የ ንስሀ ጊዜ እድል የ ላቸውም ያሉት እኚህ አባት መጽሀፍ ቅዱሳዊ ታሪክ በ መጥቀስ ነው የ ተነተኑት	ከ አሁን የ ኢጣሊያ ን ስራ ጊዜ በ የ ሌላቸው ያሉት ት እኛ አባት መግዛት ታሪክ በት ምክንያት ነው የ ነመት
ሮናልዶ መናገር የ ፈለገው ግን ህመሙ ሙሉ ለ ሙሉ ለ መዳን ጊዜ የሚ ፈልግ ግን የሚ ድን ለማ ለት ነበር	ሮናልዶ ና ነገር የ ተላለፈው ግንቦትሙ ሁሉ ለ ሙሉ ለ መሸጥ የሚቻል ግን የሚ ል ን ለማ ለት ነበር
የ እረፍ ታቸውን ም ጊዜ የ ሀዘኑ ንም ስነ ስርአት ለ ማወጅ የቤተ መንግስቱ መድፍ ሀያ አምስት ጊዜ ድምጹ ን አሰማ	የ ርታቸውን ም ጊዜያዊ ያኑ ን ስነ ስርአት ለ መገንባት የቤተ መንግስት ምክንያት አምስት ት ቴድሮስ ን
ለዚህ ውሳኔ ከ ካፍ ጠበቅ ያለ እርምጃ ና ቅጣት ይወሰን ብናል የሚ ል ፍር ቻ አለ	የዚህ ሰዎች ከ ቀረቅ ያለ ያለ እርምጃ ና ጥቃት ይሰል ብ ናል የሚ ል ስጋት ይቻላል
በቃ እንደ ፈረደ ብኝ እኔ እፈልጋ ለሁ ይላል ዘበኛ ው የ አሁኑ ን ባለስልጣን ወይን ም ጉም ቱ ተጋዳላይ	በቃ እንደ ጸረ ደንብ እንሰቀሉ ብለው ሰሞኑ ን በ ባለስልጣን ወይም የተወለዱ ት ዳለን
ኤርትራ ንብረቶቹ የ ኢትዮጵያ አለ መሆናቸው ን አረጋግጣ ለ ሳኡዲ ከ ካሳ ክፍያ ጋር እንደምት መልስ ገልጣለች	የ ዲፕሎማቶች የ ኢትዮጵያ ለ መሆናቸው ን ትኩረት ለ ሳኡዲ ባንክ እንኳ እንደምት መለስ ለች
ስለዚህ ጉዳይ አንድ ባለስልጣን ሲናገሩ መንግስት በውስጥ ቅራኔ ውስጥ ነው በ ማለት አጋጣሚ ውን ና እድሉ ን ለ መጠቀም ፈልገው ነበር ብለዋል	ስለዚህ ጉዳዩ ን የ ስልጣን ሲናገሩ መንግስት በ እርስዎ የ ውስጥ ነው በ ማለት አጋጣሚ ይ ንናሉ ን ለ መመለስ ጀምረ ዋል
ለ አንተነህ የ ጠየቀው ን አሟል ተ ን ወደ ክለቡ ብን መልስ ው በ ተጨዋቾች መካከል ልዩነት ይ ፈጠር ብናል	ለ ትናንትና የ ሰጠው አርማ ተ ን ወደ ክለቡብን መልኩ በ ተጫዋቾች መካከል ግምት ይፈረ ናል
ስለ ጦርነቱ መናገር በ እነሱ ስለሚ ያምር ጉዳዩ ን ለ እነሱ መተው በ ፈቀድኩ	ስለ ጥሩ እውነቱ መናገር በ እኛ እሱ ውስጥ ለምን ጉዳይ ም ን ለ ቀዋል
ባለፈው ሰኞ እ ለት ደግሞ በ ቴሌቭዥን ሌላ ሽልማት ሲ ሸለም ተ መልከት ኩ	ባለፈው ሰው አመት ደግሞ በ ቴሌቪዥን ሌላውን ሽልማት ሲደርስ ም ከ መላኩ
ከዚህ በፊት ይህን አይነት እድል አግኝተው ከ ተጓዙ ት መካከል አንዳንዶቹ በ ትምህርታቸው በ መግፋት የመጀመሪያ ዲግሪ ያቸውን አግኝተ ዋል	ከዚህ እ ፊቴ ና የ ንግድ ባንክ ተቀባይነት መካከል እንደ ዚህ በ መገኘታቸው በ መገኘት የመጀመሪያ ዲግሪ ያቸውን ተናግረ ዋል
ለ ግንዛቤ ያህል አንድ ሄክታር መቶ ሜትር በመቶ ሜትር ወይን ም አንድ የ ኳስ መጫወቻ ሜዳ ያህላ ል	ለ ግን ኢሳይያስ አለም አቀፍ ነት በ ቁጥጥር ስር በ እለቱ ስፖርት ኮሚሽን ም አንድ ኳስ ተጫዋች ሜዳሊያ ያስረዳ ል
ከዚያ እስከ ዛሬ ድረስ አቶ አብርሀም ያሉበት ን ትግል ና እየከፈሉ ያሉት ንም መስዋእትነት አውቃለሁ አደን ቃለሁ ም	ከዚያ እስከዛሬ ድረስ አቶ ገዛምሉ በትን ድል ና እየ ለቀቁሉ ያሉት ን መስራትነት ታውለው አቋም ም
ይሄ ባለፉት ጊዜያት ብቻ ሳይሆን አሁን ም እየ ቀጠለ ያለ ና የሚታይ ጉዳይ ነው	ይህ ባለ ሀብት ትእዛዝ ብቻ ሳይሆን አሁን ም እየ ተጠናከረ ነው የሚ ል ነው
ፑትላንድ የ ምትገኘው ጋላካዬ እስኪ ደርሱ ድረስ የ ኢትዮጵያ መከላከያ ሀይል እንዳ ጀ ባቸው ታውቋል	ቀጥሎ ም ትጥቅ ው ቃል ከ ኢሲስ ቤተ ክርስቲያን ድረስ የ ኢትዮጵያ መከላከያ ሀይል እንዳ ሻቸው ታውቋል
አሁን ም ቢሆን ባለፉት አስርት አመታት እንዳደረገ ችው ሁሉ በ ሶማሊያ ሰላም እንዲሰፍን ትሰራ ለች ብለዋል	አሁን ም ቢሆን ባለ ሀብት አመታት እንዳደረገ ው ሁሉ በ ሱማሊያ ሰላም እንዲ ንቀሳቀስ ን ተካሂ ዷል
ፍላሚንጐ ባለፈው ቅዳሜ ያስተናገ ደው በ ሪዮ ማራካኛ ስቴዲዮም ውስጥ አትሌቲኮ ሚኔይሮ ን ነበር	ስለዚህ ቋንቋ ባለፈው ቅዳሜ ሚያዝው በ የ መኮንን ወንድም መኮንን ስድስት ኮሜኝ ነበር
እንዲያ ውም ከ ሌላው አልተ ማረም ከ ሚባለው የ ህብረተሰብ ክፍል ባነሰ መጠን እራሱ ን ከ ትግሉ አርቆ ነው የ ሚገኘው	እንዲያ ውም ከ ወያኔ አልአሙ ት ከሚ ባሉ የ ንብረት ስልክ ክፍል ባልሰተት እራሱን ከ ትሉ እንኳ ነው የ ሚባለው
ከ ላይ ስለ ተገለጸው አዲሱ አይነት የ ብሄር ጭቆና ክስተት ም ግንዛቤ ያ ላቸው አይ መስሉ ም	ከዚህ ስለ ተገለጠ ው አዲስ አመት የ ዘጋጁ ት እ ኮ ና ቁጭት ም ግንዛቤ ያ ላቸው እነሱ ነው
ወደ ከተማ በሚ መጡ እንግዶች ላይ ድንጋጤ ን ይ ፈጥራል በሚል ችግሩ ባለ በት ታፍኖ እንዲያዝ ተደርጓል	ወደ ከተማዋ በሚ መጡን ችግሮች ላይ ድምጻቸው ን እፈል በሚልት ችግር አለ በት ተሻኑ ን ዘግ ቧል
የ ኢትዮጵያ ሁለት ተዋጊ ጀቶች በ አስራ ሁለት ቦንብ የ አሰብ ን አየር ጣቢያ መምታታቸው ተረጋገጠ	የ ኢትዮጵያ ሁለት ተዋጊ ጄቶች በ አስር ሁለት ሚሊዮን ያሰብ ም የ ጣውያን መብታቸው ተ ዘግ ቧል
በ ድንገት የ አንትራክስ ባክቴሪያ በ አካባቢው ስለ መረጨቱ ፖሊ ክስ ከ አንድ ከ አልታወቀ ሰው የ ስልክ ጥሪ ይ ደርሰዋል	በ ድህነት ያንራፍሬት ባካሬ ስለ ምስራቅቱ ትኩረት ከ ጥንት ጋር አዲስ ስልሳ ደርሰዋል
ጨዋታው በ አጓጊ ነቱ ቢ ጠቀስ ም የ ረባ እንቅስቃሴ ሳይ ታይ በት ሊ ፈጸም ችሏል	ጨዋታው በ ሀገሪቱ ቢደርስ ም የ ሩን እንቅስቃሴ ሳይ ታዬ በ ሊዝ ም ችሏል
አሁን ለምን ድምጻቸው ጠፋ ሁለቱ አገሮች በ ጀመሩት ጦርነት የበለጠ የ ሰጋ ው የ አሜሪካ መንግስት ነው	አሁን ለ ም እጃቸው አሳ ሁለቱ አገሮች በ ደው ጦርነት የበለጠ የ ሰብአዊ መብት መንግስት ነው
ስለሆነ ም የ አሁኑ ድጋፍ በ የ ቀኑ እየ ተሸረሸረ በ መሄድ በ ጦርነቱ ላይ አሉታዊ ውጤት እንዳይ ኖረው እፈራ ለሁ	እስካሁን ም ይሁን ድጋፍ እየ ተፈለገ ነው የ ጠፉ በት ውይይት በ ጦርነቱ ላይ ካሉታዊ ውጤት እንዳይ ኖረው ይችላሉ
አኔልካ ከ ሺ ማይክል ጋር በ ተደጋጋሚ ተገናኝ ቶ ያባ ከ ናቸው ኳሶች የሚያስ ቆጩ ናቸው	አቶ ከ ሽማዊ ጋር በ ተደጋጋሚ ጥገኝ ተው ያባከ ላቸው ኳሶች የሚያ ፉቹ ናቸው
ሊድስ ደግሞ ውድጌት ስሚዝ ፖል ሮቢንሰን ና ስቴ ፈን ማክ ፊል የተባሉ ወጣቶች ን ይ ዟል	ይህ ስ ደግሞ ውጤት ቢኮሎ ቢሊዮ ና የ ስፔን ኢንተርናሽናል ተከላካይ ባለ ሀብቶች ን ይ ዟል
በተለይ ከ ኢሀዴግ ባለስልጣኖች ጋር አብረው ሲ ሰሩ ና ሲ ያሴሩ ብዙ አመት ቆይ ተዋል	በተለይ የ ታሪክ ባለስልጣኖች ከ ራሮ ሲ ባረሩ ና ሲ ያሲንሩ ብዙ አመት ቆይ ቷል
በ ጉባኤው ላይ የ ነበሩት የ ኢነጋማ ፕሬዚዳንት አቶ ክፍሌ ሙላት ግን ጽድቁ ቀርቶ በ ወጉ በ ኮነነ ኝ ነው ያሉት	በ ጉባኤው ላይ የ ምግብ ኢነጋማ ፕሬዚዳንት አቶ ክፍል ሊ ኖራት ግን ስልኩ ቀርቶ በ ሙሉ ኩነኔ ነው ያሉት
ከዚያ ም ለ ነጋዴዎች አንድ ጠርሙስ ቢራ የሚያቀርቡ በት ዋጋ ሁለት ብር ከ ሀያ ሳንቲም ገደማ መሆኑን ይናገራሉ	ከዚያ ም ለ ነጋዴዎች አንታ እስከም የሚ ቀርቡ በት ዋጋ ሁለት ችግር አስራት ገደማ መሆኑን ይናገራሉ
አቶ አባተ ኪሾ ያለ መከሰስ መብታቸው መገፈፉን የ ፌዴራሉ ከፍተኛ ፍርድ ቤት አስ ታወቀ	አቶ አባተ ኪሾ ና ያለ መልስ ክስተታቸው መደሰታቸው ን የ ሚያስችሉ ከፍተኛ ፍርድ ቤት አስ ታወቀ
ስለዚህ ም የ ቤት ስራው ን ሳይሰራ የ ትምህርት ጊዜ የ ደረሰበት ተማሪ መስሏ ል	ስለዚህ ም የ ቤት ስራው ን ኢሳይያስ የ ትምህርት ጊዜ የደረሰ በት ተግባር ይወስዳ ል
ይህን ሞዳሊቲ ለ ማስፈጸም ሀላፊነት የ ተጣለባቸው የ አልጀሪያ ው ፕሬዚዳንት ና አዲሱ የ አአድ ዋ ና ጸሀፊ ናቸው	ይህ ሞራሊቲ ለ ማጠናከር ነት የ አለ ባቸው የ ማዳበሪያ ው ፕሬዚዳንት አዲሱ የ አግ ዋ ና ጸሀፊ ናቸው
በ ሀገራችን የ ቅርብ ዘመን ታሪክ ውስጥ አራት አዲስ ምእራፍ ከፋች ሁ ነቶች መጥቀስ ይቻላል	በ አገራችን ም የ ክለብ ዘመን ታሪክ ውስጥ አራት አዲስ ዩኒቨርሲፍ ተዋል
ቅዱስ መጽሀፍ ድሆች ን መናቅ ና መዘንጋት እንደማይገባ ን የሚያ ስጠነቅቀን እንዲ ህ ሲል ነው	ቅዱስ ጊዮርጊስ ለ ሌሎች ን መናቅ ና መዘጋት እንደማይገባ ን የሚያ ያውቅ እንዲ ህ ሲሉ
ቡና ገበያ አደገኛ የሚለው ዜማ ቸው በተለይ መታወቂያ ቸው ሆኗል	ቡና ገበሬው ትክክለኛ የ ሌላቸው በተለይ መከያቸው ሆኗል
እኚህ ወገኖቻችን ደግሞ አፍርሰው የሚ ገዙ ሆኑ	እንዲያ ውም ወገኖቻችን ደግሞ አረፈ ው የሚሰሩ አሉ
በ ኤርትራ ና በ ትግራይ ጉዳይ የ ቀረበላቸው ና የ ሰጡት መልስ ቀጥሎ ቀርቧል	በ ኤርትራ ና በ ትግራይ ጉዳይ የ በኩላቸው ና የ ሰጡት መልስ ቀጥሎ ቀርቧል
በ ብሄራዊ ሊጉ ከ ከተማ ወደ ከተማ መ ዘዋወሩ ተጨማሪ ወጪ ያስከትል ብናል	በ ብሄራዊ ሊግ ከ ከተማዋ ወደ ከተማ መጸብር ቶማዊ ወጪ ያስ ደል ብን
ሻጭ ም ገዢ ም ከዚህ ከተ ፈቀደው ቦታ በ ቀር ከ ሌላ ዘንድ ስት ገዛ የተገኘ ህ ሰው በ ከ ብት ህ ት ቀጣ ለህ	ስራው ም ከዚህ ም ከዚህ በ ተመለከተው በ በኩል ከ ላዚዮ እንድ ስት ገዛው የተገኘው በ ቅርብ ይታ ያል
ለ አገራችን ፖለቲካ የ እንጀራ ልጅ ሆነ ናል የሚሉ ወገኖች ብረት ማንሳታቸው ን እየ ነገሩን ነው	ለ ሀገራችን ትኩረት የመጀመሪያ ልጇ ንና ሊ ሉ ወገኖች እጥረት ማምከታቸው ን እየ ለቀቁ ነው
ኢትዮጵያ በ አለም ቀይ መስቀል ፊት ለፊት በ ግልጽ ለ ደህንነቷ የሚያ ሰጉ ኤርትራውያን ን ለ ማባረር ተገዳ ለች	ኢትዮጵያ በ አል ቀን ምክር ቤት ለፊት በ ማደስ ለ ደህንነት የሚ ያስገቡ ኤርትራውያን የ ማባረር ለች
አለ ዚያ ከ ጉባኤ ዎቻቸው ከ ስብሰባ ዎቻቸው ና ከ ዲስኩራቸው ለ ህዝብ ና ለ አገር የተረፈ ነገር አላ የ ንም	እነዚሁ ከ ተወካዮቻቸው ከ ስብሰባው ዎቻቸው ና ከ አቅማቸው ለ እሱ እና ለ ሀገር የተደረገ ነገር አላ የ ለ ም
ለ ኢኮኖሚው እድገት መጨመር ማሳያ በ ግብርናው ዘርፍ ገበያ አጣ እንጂ ምርት ጨ ም ሯል	ለ ምሳሌ ም የ እጥረት መርር ሳቢያ በ ቅርቡ ቡድን ነው ዶክተር ደረጃ ጣ እንጂ ምርት ጀም ሯል
ከዚያ በ ተኛች በት ጠብ ስቃ ከ አልጋ ጋር አጣብቃ በ መያዝ አንገቷ ን በ ቢላ መቁረጥ ት ጀምራ ለች	ከዚያ በት ትንሽ በ ትልቅ ከ ሀይል ጋራ ጠጋ በሚ ያስተዳድሩን በደል ለ መግዛት ጀም ሯል
በ ሶስተኛው ደረጃ ደግሞ አምባገነኑ ን ስርአት በ ስሙ የሚጠራ በመሆኑ ም አብዛኛው ኢትዮጵያዊ ያከብ ረዋል	በ ሶስተኛው ደረጃ ደግሞ ባመኑ ን ስርአት በ ሰሞኑ የሚ ደረገው በመሆኑን አማጺያን ነው የሚ ያ ፈጽሟ ል
የምድር ባቡር ድርጅት መንገደኞች ን የ ማጓጓዝ አገልግሎት ካለፈ ው ሁለት ሳምንት ጀምሮ መቋረጡ ታወቀ	የሚ መራው ድርጅት ድርጅት ን የ ማጓጓገ አገልግሎት ካለፈ ው ሁለት ሳምንት ጀምሮ መጀመራቸው ታወቀ
የ አዲስ አበባ ስታዲዮም ተመልካች ቄራ የሚ ል ቅጽል ስ ም አውጥቶ ልሀል	የ አዲስ አበባ ስቴዲዮም ባለሙያዎች ትግራይ የሚ ልቀል ስ ም ተገኝተው ል
ሪቻርድ ቡ ሽር ውይይቱ ገንቢ እንደ ነበረ ቢገልጹ ም ዝርዝር ጉዳዮች ን ከ ማስረዳት ተቆጥ በዋል	ፕሮፌሰር በየነ ጴጥሮስ ደንቅ ና አመራር ቢገልጹ ን ፍቅሩ ጉዳዮች ን ከ መስጠት ተቆጥ ረዋል
ለዚህ ደግሞ መንግስት በ አ መቻቸ ለት የ ብድር አገልግሎት መጠቀም ይገባ ዋል	ለዚህ ደግሞ መንግስት በመቶች እ ለት የ ውድድር አገልግሎት መጠቀምም ጠይቀ ዋል
የ ብራዚል ሻምፒዮና ልክ እንደ በፊቱ የ ኢትዮጵያ ሻምፒዮና ውድድር አይነት መንገድ ነው የ ሚከተለው	የ ፌዴራል ኢንሹራንስ ን ልክ እንደ ገለጸው የ ኢትዮጵያ ሻምፒዮናን ውድድር ማግኘት እንዳለ ነው የሚ ከተ ነው
ክለቦቹ ግን በ ተጫወቱ በት ወቅት ከ ቴሌቭዥን በ የ ጨዋታው ስድስት መቶ ሺ ብር ገቢ ያገኛ ሉ	ክለቦቹ ግን በ ቀጥጡ በት ወቅት ሬን ን በ የ ጨዋታው ስድስት መቶ ሺህ ብር ገቢ ያገኛ ሉ
እንደ ዲፕሎማቱ ከሆነ የ ሻእቢያ ባለ ስልጣናት የ ኢትዮጵያ ጦር አሰብ ን ለ መያዝ ቆር ጧል ብለው እራሳቸው ን አሳምነ ዋል	እንደ ጦርነቱ ከሆነ የ ሻእቢያ ባለስልጣናት የ ኢትዮጵያ ጦር አዛዦች ለ መላኩ ት ባል ለ ራሳቸው ን አ ሰምተዋል
በዚህ ግንባር የ ራስ አነሳ ሽ ነቱ በ ሱዳን ሰራዊት እጅ እንደሆነ ለማ ንም ግልጽ ነው	በዚህ ግን ግንባር ሀምሳሳመቱ በ ሱዳን ሰራዊት ተቋም እንደሆነ ለ ማ ንም ግልጽ ነው
ሌሎቹ ደግሞ በ አለም አቀፍ ህብረተሰብ ዘንድ የተለየ መልክ ና ተቀባይነት ን ለ ማግኘት የተነገረ እንደሆነ ይናገራሉ	ሌሎቹ ደግሞ በ ማገፈ በትን የተለያዩ የ ልማት ና ተቀባይነት ለ ማግኘት የ ላቸውም እንደሆነ ይናገራሉ
ቀደም ሲል ሚኒስትሮች ና ጄኔራሎች አምስት መቶ ሜትር ካሬ ቦታ በ ነጻ መውሰዳቸው ይታወ ቃል	ቀደም ሲል በ ሚኒስትሮች ና ሌሎች አምስት መቶ ዶላር ታስወጣታ በ ነጻ መስዳቸው ታወቀ
ይህ በ እንዲ ህ እንዳለ አዲስ አባ ውስጥ የ ጨው ዋጋ ን ሮ ይገኝ እንጂ በ ሌሎች ምርቶች ላይ የ ዋጋ ለውጥ አልታየ ም	ይህ እንዲ ህ እንዳለ አዲስ ውስጥ የ ጠጋንዳ የ ሚገኘው በ ሌሎች መሪዎች ላይ የ ጋለጥ አል የ ም
በ አሁኑ ም ወቅት ሁለቱ ም ወገኖች አልፎ አልፎ በ አካባቢው የ ተኩስ ልውውጥ እያደረጉ መሆኑ ታውቋል	በ አሁኑ ም ወቅት ሁለቱ ም ወገኖች አልፈፉ በ አካባቢው የተ ተኩስት እያደረጉ መሆኑ ታውቋል
ከ ድንበር ግጭቱ ማግስት ዘርፈ ብዙ ጥል ፍልፍ ፖለቲካዊ ህ ሳቤ ዎች እየ ተስተናገዱ ናቸው	ከ ግንባር ግጭት ማገዘፈ በ ብዛት ዘርፍ የፖለቲካ እስረኞች ቤተ ክርስቲያን ናቸው
መፍትሄ የሚደረግ ለት ከሆነ የ ሻእቢያ እጆች ወይ መሰብሰብ አ ሊያ ም መቆረጥ አለ ባቸው	መፍትሄ የሚደረግ ለት ከሆነ የ ሻእቢያ መሪዎች ውን ይሰ ው ለ መግዛት አለ ባቸው
ወርቅ ና ብር ቡና ና አ ህል ጋሞጐፋ አለ በሚል ሽፋን ደብዳቤ ም እየ ጻፈ የ ድብቅ ማህበር አ ቋቋመ	ውድቅ ና በ ቅርቡ ና ና እገዛ ምቆሰ አለ በሚል ሽፋን ና የሚ ሳተፉ የ ደህንነት መዋቅር አቋም ም
ፕሬዝዳንት ካምፓዎሬ ከ እሳቸው ጋር ወደ ኢትዮጵያ ና ኤርትራ እንዲ መጡ ተማጥነ ዋቸው ነበር	ፕሬዚዳንት ነጋሶ ጊዳዳ ከ ሰራጨው ጋር ወደ ኢትዮጵያ ና ኤርትራ እንዲ መጡ ለማወቅ መሆናቸው ነበር
በ ሰሞኑ የ ድንበር ውዝግብ ዙሪያ የ ተጠናከረ ው ዘገባ ቀጥሎ ቀርቧል	በ ሰሞኑ የ ድንበሩ ስልግ ስልጠና የ ተደረገው ዘገባ ተከትሎ ቀርቧል
አሰልጣኙ በ እርግጥ ም ብሄራዊ ቡድኑ ን ከ ያዙ ወዲህ ክለቡ እየ ተሸነፈ ነው	አሰልጣኙ በ እርግጥ በ ብሄራዊ ቡድኑ ን ከ ያዙ ው ወዲህ ከባድ እየ ተፈጸመባቸው ነው
ስዩም ነው የ ጻፈው ብሎ ጽሁፉ ን አይቼ የ እርሱ አለመሆኑ ን ስ ነግረው እኔ የ ማውቀው ነገር የ ለ ም ነው ያለ ኝ	ስም ነው የ ፈ ው ብሎ ብለው ላዚዮ የ ረሱ አለመሆኑ ን ስለ ነበረ ው እኔ የተባለ ውን የ ለ ም ይላል
ይህ ሰው ውሀ ልማት አካባቢ በ ሚገኘው መኖሪያ ቤቱ የ ታሸገ በት ሲሆን እርሱ ም የ ደረሰበት አይ ታወቅ	የ ሰው ባህል አባላት በ ሚገኘው ማእከላዊ ቤቱ የተነሳ በ ሲሆን እቅድ ሊ በት አይ ታወቀ
ጉባኤው በ ኤርትራ ና በ ኢትዮጵያ ጉዳይ ተወያይቶ የኤርትራ መንግስት ወረራ ን ተቃው ሟል	ጉባኤው በ ኤርትራ ና በ ኢትዮጵያ የ ጉዳይ ውይይቱ የኤርትራ መንግስት ወገን ተጠቁ ሟል
ሊደረግ ለ ታሰበው ለውጥ ጥናትና ዝግጅቱ ን እየተገባደደ ነው ብለዋል	ሊቢያ ለሰበ ው ሁለት ቀናት ና ጥናቱ ን ውይይት ቀጥ ሏል
የክልሉ የስራ ቋንቋ ኦሮምኛ እንዲሆን ም ተወ ስ ኗል	ይህ አይደለም የስራ ቋንቋሎኛ እንዲሆን ም ተጠየቁ
ውስጣዊ አንድነቱ ዲሲፕሊኑ የስራ ዝግጁ ነቱ ወደሚ ፈልገው ደረጃ መድረስ መቻል አለ በት	ጉባኤው የ አንድነት ዲስፕሊኑ የስራ አስኪያጅ ነት ወደ ኋላ ደረጃ መዝ መቻል አለ በት
በዚህ ምክንያት ወሳኝ የሆኑት ን ተጫዋቾች ን እያጣ ን ነው	በዚህ ምክንያት ወሳኝ የሆኑት ን ተጫዋቾች ን እያጣ ን ነው
ህዝቡ ም እንደ ለመደው እንዳይ ነጋገር ወደ ተግባራዊ ውሳኔው እንዳ ያዘነብል መንገዱ ን አጠር ን በት	ህዝቡ ም እንደ ዚያው እንዳይ ነብ ወደ ተግባራዊ ውሳኔ እንዲ ያብር መንገድ ን አስተናግ በት
የዚህ ባንድ ታሪክ እንደሚ ያስረዳ ው ከሆነ በ ዘመናቸው አቻ ያልተገኘ ላቸው የ ሮክ ባንድ ተ ብለዋል	የዚህ ባንሊክ እንደሚ ያስረዳ ው ከሆነ በ ዘመናቸው ጋር ተገናኝ ላቸው የኦሮሞ ባንክ ተ ው ለዋል
በ ኢንተርናሽናል ግጥሚያ ቡና ና ከነማ አሳምነ ው ሲ ያሸንፉ ጊዮርጊስ በ ቪታሎ ተሸነፈ	በ እያንዳንዱ ኢንተርናሽናል ግጥሚያ ና ሰለሞን ሳመ ሲ ያገኝፉ አዲስ በ ሚካሄደው ተ ከናውኗል
ከ ሻእቢያ አምልጠ ው የመን የ ገቡ ኢትዮጵያውያ ን ወደ ሀገራቸው ገቡ	ከ ሻእቢያ የ ምርጥ ኢትዮጵያውያ ን ን ደቡብ ኢትዮጵያ ን ወደ ሀገራቸው ገቡ
ውጤቱ የጠመመ በትን ሊቨርፑል የ ቀድሞው ዝናው ን ለ ማስመለስ እንደሚ ጠሩ ይናገራሉ	ውጤቱ ን የ ታመሙ በትን ሊ ባልክል ደክመ ው ለ ማስመለስ እንደሚ ችል ይናገራሉ
በ ቅዳሜ የ ተደረጉት ግጥሚያ ዎች ለ ተመልካቹ ቁጥር ዝቅተኛ መሆን ምክንያት ሆኗል	በ ግዳጅ የ ተደረጉት ግጥሚያ ዎች የተደራጀ ው ቁጥር ግጥሚያ መሆን ምክንያት ሆኗል
የ ት ራንሱ ግብ ጠባቂ ከ ተመልካች አድናቆት ን ተ ችሮታ ል	የ ስፔን ቡድን ጠጣ ከ ተደረገካ ትላንትናት ን ተ ጀምሮ ታል
ባሊዶግሌ የ ኢትዮጵያ ጦር ተቆጣጥሮ ታል የ ተባለው የ አይሮፕላን ማረፊያ የሚ ገኝበት ከተማ ነው	በ ደቡብ ጊዜ የ ኢትዮጵያ ተፋሰሩ ታሪክ የ አጂፕ ሚንስትር የሚ ባል በ ከተማ ነው
ከ አቅም በላይ የሆነ ችግር ባይኖር ኖሮ ለ ማሰልጠን ፍቃደኛ ነበርኩ ኝ	ታሪክ ም በላይ የ ኦነግ ችግር ባይ ኖሮ ለ መግን አሰልጣኝኛ ነበርኩ ን
በዚህ ም ለ አገራቸው ና ለአፍሪካ ም ን ያህል ይ ጨነቁ እንደ ነበር ለ መገንዘብ ች ያለሁ	በዚህ ም ለ ሀገራቸው ና ለ ጸሀፊ ም ን ያልቅ ሊሆን ናቁ እንደ ነበር ለ መግለጽ አይደለም
ከ ኢትኦጵ ያ ነሀሴ አስራ ሁለት ቀን አንድ ሺ ዘጠኝ መቶ ዘጠና አንድ ወጣ	ከ ኢትዮጵያ ን አፍቃሪ አስራ ሁለት ቀን አንድ ሺ ዘጠኝ መቶ ለ አንድ አሸን
ከ ቤተሰባችን መካከል በ እርሻ ተግባር ላይ ያል ተሰማራ ችው እናታችን ብቻ ነበረች	ጥቂት ሰባቷ ን መካከል ሽፋንር ላይ ተሰማራቸው ን እናታ ችንን ብቻ የ ነበረች
መንግስት የ መለሳቸው የቤተ ክህነት ህንጻዎች ከ አባ ጳውሎስ እጅ እንደማይ ወጡ ተገለጸ	መንግስት የ መለስሳቸው የ ቤተ ክህነት ን ሰዎች ከ አባ ጳውሎስ እጅ እንደማያውቁ ተገለጸ
አጠቃላይ ወጪው አስራ ስምንት ሺ ዶላር እንደሆነ ለማወቅ ተችሏል	ባጠቃላይ ወጪ አስራ ስምንት ሺ ዶላር እንደሆነ ለማወቅ ተችሏል
የ ኢትዮጵያ መንግስት ደቡብ አፍሪካ ኮ ሮ ኔል መንግስቱ ን አሳልፋ እንድት ሰጣት ጠየቀ	የ ኢትዮጵያ መንግስት ወደ ኒውዮርክ ኮሎኒ መንግስት አምስት ፐርሰንት ተጠየቀ
ለ ችግሩ በጐ ምላሽ ማግኘት የሚ ቻለው ከ ካፍ ዘንድ ነው	ለ ችግሮቹ በ በኩላቸው ምክንያት የሚቻል ት ከባድ ተደረገ
ለማ ን አቤት ማለት እንደሚ ቻል ም ግራ ገብቶ ናል በ ማለት ነጋዴ ዎቹ ብሶ ታቸውን ገልጸዋል	ለ ማናሬት ማለት እንደሚ ቻል ም ግራ ገብቶ ናል በ ማለት ነጋዴ ዎቹ ብዙ ታቸውን ገልጸዋል
ከ ኳስ ኋላ ሲ ሮጡ የሚ ስተዋሉ ት በፊት ም አሁን ም ሀያ ሁለት ተጫዋቾች ናቸው	ከ ኳስ ጋር ሲሮጡ የመንግስት በፊት ተብሎ ም ሀያ ስምንት ወታደሮች ናቸው
ቡድኑ ባደረ ጋቸው ሶስት ጨዋታዎች ውስጥ ሁለቱ ን አቻ ሲ ወጣ በ አንዱ ተሸን ፏል	ቡድኑ ባደረገ ቸው ሶስት ጨዋታዎች ውስጥ ሁለቱ ን አ ሲሉጣ ባንክ ተሸን ፏል
ነገር ግን አንድ ቀን ራሱን በ ቻለ ሂደት ና መልክ ሊ ከናወን የሚችል የ ማይቀር ድርጊት ነው	ነገር ግን አንድ ቀን ኳሶን የ ውይይት ና መብት ይ ከናወን የሚ ችል የ መናገር ውጤት ነው
የኢ ሲ ኤ ሴኩሪቱ ሀላፊ የ ተዛባ ዜና ተላል ፏል አሉ	የ ጊዮርጊስ ኤሲ ሚላን ሀላፊዎች ተቀባይነት አግኝተ ዋል
ይህንን ም ባድመን ና ሽራሮ ን በ መውረር እ ውን አ ርጓል	ይህንን ም ባድመ ንናሻው ን በ መቃወር በ መሆን ተሾሙ
በምን እንደ ታሰሩ የሚያ ቁት የ መዝገብ ቤት ሰራተኞች ናቸው	በምን እንደ ተናገሩት የሚ ያውቁት የ መስሪያ ቤት ሰራተኞች ናቸው
የ አን ግሎ ኢትዮጵያ ን ማህበር ኤርትራ ሰራዊቷ ን እንድ ታስወጣ ጠየቀ	የ አንድ መቶ ኢትዮጵያ ን ማህበር ኤርትራ ሰራዊቷ ን እንድታፋ ተጠየቀ
ኢትዮጵያ ሉአላዊ ነቷን ለ ማስከበር መብቱ ም ሀይሉ ም አላ ት	ኢትዮጵያ በ አንሚ እንድን ለ ማስከበር መጥቱ አይሉ ም አለት
ሀማ ን በ በርገር ላይ ም እንዲ ሁ ፋው ል በ መስራቱ በ ሁለት ቢጫ ከ ሜዳ ተወግ ዷል	ባድመ በ በ እግር ላይ ም እንዲ ሁ ታሎሉ ስራው በ ሁለት ብቻ ተካሂ ዷል
ግን እነሱ አፈን ግጠው ባይ ወጡ ልዩነቱ መ ጥበብ ይችል ነበር	ግን እነሱ አልፎጣው ምጽዋ ሊ ገናኙ መጥኝ ነበር
በተለይ በ ደቡብ በኩል ባላባቶች ከፍተኛ ሁከት እየ ፈጠሩ ነበር	በተለይ በ ደቡብ በኩል ህጻናቶች ከፍተኛ እውቀት እየ ተጠሩ ነበር
እንደ ገና ኢትዮጵያዊ ለ መሆን መደራደር የ መረጡ ም አሉ	እንደ ገና ኢትዮጵያ ኢትዮጵያዊ ለ መሆኑን መጣር የ እነሱ ም አሉ
በ አፋር ከሚ ያስፈልገው እህል አርባ ስድስት ከ መቶ ብቻ ነው የ ቀረበው	ፓትርያርኩ በሚ ዘጋጀው እኔ አርባ ስድስት ከ መቶ ብቻ ነው
እንደ ተመለከትነው አሰልጣኝ ተስፋዬ እስከ እረፍት ከ መቀመጫ ው አልተ ነሳም ነበር	እንደ ተፈት አሰልጣኝ ተመሳሳይ ህዝብ ከ አራት ወራት ቀጥው አልቻለ ም ነበር
የ ትግራይ ህዝብ ድርጅት እየ ጐዳና እያ ቆሰለ እንጂ አላዳ ነው ም	የ ትግራይ ህዝብ የ ድርጅት ን እየ ጐዳ ና እውቀት ለ እንጂ አላደ ነው
ከ አሁን ወዲያ ተመልካቹ ን ወደ ሜዳ ለ መመለስ ም ንም አይነት መፍትሄ ሊ ያበጁ ለት አይችሉ ም	ከ አሁኑ ወቅታዊ ን ወገን ና ለ መመለስ ም ንም አይነት መስሪያ ቤቶች ለ ም
ኢትዮጵያ ወደቡ ን በ ነጻ የ ም ትጠቀምበት ሁኔታ ይ መቻቻል ተ ባለ	ኢትዮጵያ ወደቡ ን በ እነዚህ እን ጠቀም በትን የደረሰ ን ተ ባለ
መስኮ ቦች ን በ ማሰለፍ ብቻ ኢሳይያስ ኢትዮጵያ ን ለ ማንበርከክ ይችላሉ	ብዙዎች ን በ ማስተናገፍ ብቻ ሳይሆን ኢትዮጵያ ን ለ መመልከት ከ ህግ አይደሉም
ነገር ግን ተጫዋቹ ን የሚ ፈልገው ክለቡ እንጂ አሰልጣኝ ጉሌት አልነበረ ም	ነገር ግን ተጫዋቾቹ ን የሚ ሰልለው ክለቡ እንጂ ወንጀኝ ን ውጤት ነበረ
መለስ ና ኢሳያስ እርስ በ እርስ ለ መገለባበጥ እየ ሞከሩ ነው	መለስ ና ኢሳያስስ እርስ በርስ ለ መቀበልበት እየ ሞከሩ ነው
በ ዶክተር ታዬ ወልደሰማያት ላይ የሚ ሰማው ውሳኔ በ ዳኛው አለ መገኘት ተራዘመ	በ ዶክተር ታዬ ን ለ ማግኘት ላይ የሚ ሰጠው ውሳኔ በ ደንብ ለምንኝት አልተቻለ ም
በ ሀገራችን ግን የ ረባ ሜዳ እንኳ ን የ ለ ንም	በ ሀገራችን ግን የ ረሜ እንኳ ን የ ለ ንም
ማ ንም ዜጋ ማ ንም ደም ይ ኑረው ልክ እሱ እንዳለው ወሳኙ አመለካከቱ ነው	ማን ንም ካለማ ማ ንም ገሮው ልክ ስ እንዳለው አሰልጣኙ ማለቱ ነው
በ አውሮፓ መድረክ ላይ በ ጥሎ ማለፍ ዋንጫው ላይ ለ ሩብ ፍጻሜ ማለፉ ን አረጋ ግጧል	በ አውሮፓ ወቅታዊ በት ፕሮግራም ዋንጫው ላይ ለ እቅድም ማለፍ ና አረጋ ቷል
ሁሴን አይዲድ በ አሊትሀድ ላይ አቋም ወሰዱ ስምምነት ም አደረጉ	ሁሴን አይዲድ በ ጣሊያን ላይ አቋምወድ ስምምነት ም አደረጉ
ሰላም ለ እናንተ ይሁን እ ድምተኞቼ እኔ አሽሙረኛ ው ለ እናንተ ሰላም ና ጤናው ን እመ ኛለሁ	ሰላም ም በ እናንተ የ ኦነግ ም ትንሽ የ ኬንያ ዊረኛው ን ሰላም ና ጤናው ን እን ኛለን
ክለባችን የተመሰረተ ው በ አንድ ሺ ዘጠኝ መቶ ዘጠና ነበር	ክለባቸው የ ሰጡትው በ አንድ ሺ ዘጠኝ መቶ ፐርሰን ነበር
በ አቶ መለስ የተጠራ ው ይህ የ ጦር ጄኔራሎች ስብሰባ አሁን ም እንደ ቀጠለ ነው ተ ብሏል	በ አቶ መለስ ዜናዊ የ ታሪክ ያሉ ስብሰባ አሁን ም እንደ ቀጠለ ነው ተ ብሏል
ቤተ እስራኤሎች ን አጠቃ ላ ለ መውሰድ እስራኤል እያጠና ች ነው	በ እስራኤሎች ን አጋጣሚ ለ ለ መውሰድ እስራኤል እያ ጣ ች ነው
ጋዜጠኞች ን መለያየታቸው ብዙዎች ን አሳዝኗ ል	ጋዜጠኞች ን መያዝቸው ብዙዎች ን አሳ ሰሩ
ያን ን የመሰለ ጥያቄ አንስቶ በ ማሾፍ ና በ ማጣጣል ማለፍ ከባድ ነው	ያን ን የ መግዛት ጥያቄስ በ ማንቋሸፍ ና ለ ማስፋፋት አለ ባል
መብራት ሀይል በ ውሳኔው ተጠቃሚ ሳይሆን እንደማይ ቀር ከ ዜና ምንጮቻችን ለ መረዳት ች ለናል	መግዛት በ ቀን ን በቃሚ ሳይ እንዳደር ከ ዜና ምንጮቹ ለ መረዳት ተችሏል
አሁን ም በ የክልሉ እየ ተዘዋወሩ ፕሮጀክቱ ን እየ ገመገሙ ናቸው	አሁን ም በተ የክሉ እየተ ሰሩሩ ፕሮጀክቱ ን እየገቡ ናቸው
እኛ ም ወስፋ ት ይሆናል እያ ልን በኋላ በኋላ ነው ይህ የ ወጣለት	እኛ ም ሰአት እያ ለ ን በ ማለት በኋላ ነው የ እ ለት
በ ኤርትራ በኩል በ ተመሳሳይ መልኩ የተወሰኑ አላማዎች መነደፋቸው ን እሙን ነው	በ ኤርትራ በኩል ግን በ ተመሳሳይ ፊ ቶች ሰሞኑ ባለሙያዎች መመሪያፋቸው ን መሆን ነው
ግን በጣም ጥሩ ይሆናል የሚ ል ሀሳብ አልነበረ ኝም	ግን በጣም ጥሩ ችሎታ ና የሚ ል አስራ አመት ተ ባለ
ግብጽ በ አባይ ውሀ ላይ የ ኮታ ጥያቄ አቀረበች	ግብጽ በ አባይ ውሀ ላይ የ ወጣት ጥያቄ አቅርች
በ ላይኛው በር ሄድ ን ስን ጠይቅ ም ንም አናውቅ ም ሂዱ ከዚህ ብለው ናል	በ ሁለተኛው በር ክልል ስልጠና ም ንም አናውቅ ም ሲሉ ከዚህ ብለው ናል
የ ኮሚሽኑ ውሳኔ ና የቤተ ክህነቱ ተቃውሞ	የ ኮሚሽኑ ውሳኔ ና የ ዴታ ከ ስልጣናቸው ተባረሩ
ልኡኩ ከ አንድ ወር በኋላ አዲስ አባ ና አስመራ ይገባል ተብሎ ይጠበቃል	ልክ አንድ መቶ ዶላር አዲስ አበባ ና አስመራ ተግባር ተብሎ ይጠበቃል
ጉዳዩ ን በ ቅርብ ለምን ከታተለው ሰዎች ም ንም አስደንጋጭ ይዘት የ ለውም	ጉዳዩ ን በ ቅርብ ለምን ከለው ሰዎች ም ን ማስጠንቀቂያ የ ለውም
ድንበራችን አሰብ ድረስ ነው እኛ የ አንድነት ደቀ መዛሙርት ነን	ችግሩችን አሰብንስ ነው እኛ የ አንድነት ደግሞ ስምንት ነን
ሌላው የ ግምገማው እርሰ ጉዳይ ሆኖ የ ቀረበው አሰራር ዘለል የ ሚባለው ነው	ይኸው ግን እግር ኳስ ጉዳዩ ን የ ጀመረችው ስራ አስፈጻሚል የሚ ባል ነው
ሁላችን ም ከ ስህተ ቶቻችን እንድን ማር ያደርገ ናል	ሁላችን ን ከ ስልጣንተ ችንን እን መራ ዋለን
እዚህ ላይ ጉ ሪ ሚ ዮ ቀሪ ሁለት ጨዋታ አለ ው	እዚህ ላይ ጉባኤው ያውካ ው ለውጥ ጨዋታ አለ ው
ይሁን እንጂ ይህ አባባል እንደ ስህተት እንዳል ተቆጠረ ተንጸባ ርቋል	ይሁን እንጂ ያበን ን እንደ ሰሩት እንዳል ታወቅ ተ ነግ ሯል
እና በኋላ ነው ስራ እየተፈጠረ ለት የ መጣው	እና በ አለም ነው ስራ የተ ጠጡ ት የ መጡ
አምስተኛው ግብጻዊ ሲ ሆኑ ዳግም ለ መመረጥ እንደማይ ፈልጉ ታውቋል	ሶስተኛው ግን ሳዊ ሲሆን ዳም ለ መግዛት እንደማ ያገኙ ታውቋል
በ ቀዳዳ የሚገባ ንጹህ አየር ታገኛ ለችና	በ አጠቃላይ የሚ ቆጠሩ ን እንሰማ የ ትገኛኛ ነን
ጅቡ ም ወጣቷ ን ተከታትሎ ይበላ ታል ማለት ነው ይስማ ታል	ችግሩ ም ወገን ን ተቀብሎ ይ ብላል ማለት ነው የ ስሟ ታል
ላዚዮ ና ሚላን ስ እንዴት ተዘ ነጉ ይሄ የ እኛ ሀሳብ ነው	ለዚህ ና ሚላን ም እንዴት ተሰነቁ ይሄዬ ን ሀሳብ ነው
ከዚያ ም የክልሉ ኮሚሽን ጃንሜዳ ቢሮ ስለ ሰጠን ወደዚያ ው ሄድ ን	ከዚያ ም የ ክልሉ ኮሚሽን ኢንተር ሚላሩ ስለ ዘጠኝ ትእዛዝ ኤ ም
ይህንን በ ትክክል የሚ ያውቁት እነሱ ብቻ ናቸው	ይህንን በ ትክክለኛ የሚያ ጫወት እነርሱ ብቻ ናቸው
የ ወለደው ን ልጅ ለ ማስተማር ተስኖ ታል	የ ወረዳው ሌሎች ለ ምስክርነት ተሰረ
ለዚህ ም ይመ ስላል ባ ነሱት ነጥብ ላይ ብዙ ም ውረፋ አል በዛባቸው ም	ለዚህ ኢንተር ሚላን ትራንስፖርት ላይ ብዙው ን በደል ተፈጸመባቸው
እንደ በፊቱ በ አገሩ ላይ ባይተዋር ነቱም ቀር ቷል	እንደ ጣት አገሩ ላይ ባይ ጦርነት ን ቀር ተዋል
የ ሶማሊያ መንግስት ሀገሪቱ ን የ አሸባሪዎች መ ና አ ሪያ እ ያደረጋት ነው ተ ባለ	የ ሶማሊያ መንግስት አጂቱ ን የ አሸባሪዎች መ ደብደባት ነው ተ ባለ
ጡረታ ው እንዲ ከበር ለት የማይ ፈልግ ማ ንም የ ለ ም	ችሎታው ን እንዲ ቀበለው የ ላት የ ልማት ሀብማ ን የ ለ ም
እነዚህ ሰዎች ጨርሰው ጅል አደረጉ ን	እነዚህ ሰዎች መጥተው ትክክል አደረግ ን
የ ኦነግ ታጣቂዎች በ ኬንያ ወታደሮች ተከበቡ	የ ኦነግ ተወካዮች በ ኬንያ ወታደሮች ተ ደበደቡ
በ እርግጥ በ አንዳንድ ምሁራን ጥሩ ሀሳቦች ተ ሰንዝ ረዋል ብለዋል	በ እቅዱ በ አንዳንድ ም ፉትቦል ፌዴሬሽን ደርሷ ል
በዚህ ሰሞን ነው ከ ኳስ ጋር የ ተያያዘ ልምምድ መስራት የ ጀመርነው	በዚህ ደርሰው እ ኮ ኳስ ደረጃ የ ሀይል ምግብ ዋስት የ ጀመረ ነው
ችግሮቹ ን ደግሞ ማስወገድ ነበረ ባቸው	ተጫዋቹ ን ደግሞ ማሰብብድ ነበረ ባቸው
ቴክኒሻኑ አስቶን ቪላ ን በ ገንዘብ መጉዳት አያሻ ም	ቴክኒኒ ሻኑ አስጊላ ን በ ገንዘብ ጉዳት አልቻለ ም
ሰውዬው በልጅነ ቱ ሱዳን በ ስደተኝነት የ ኖረ ነው	ሰውዬው በ ባለቤቱ ሱዳን በ ስደትኝነት የ መኖር ነው
ከ መጋረጃ ጀርባ ወንጀል ተ ፈጽሟ ል የሚ ል ነገር የ ለ ም	ሸክላ ሰሪዋ ወንጀል ተቀባይ የሚ ነገር የ ለ ም
ክሊንተን በ ኢትዮ ኤርትራ ጉዳይ በግል እንዲ ገቡ ተጠየቀ	ቃል ን በ ተመሳሳይ በ ጉዳይ በ ትክክል እንዲ ያቆሙ ተጠየቀ
ኢትዮጵያዊያ ን ጀግኖች መሆናችን ል ና ሳ ያቸው ይገባናል	ኢትዮጵያውያ ን ሹፌሮች መሆናቸው ል ና ሳ ያገኝ ይባላል
ቡድኑ በ ማጥቃት ላይ የተመረኮዘ ፉትቦል ነው የሚ ጫወተው	ቡድኑ በ ማጣራት ላይ የ ተማርኮፉ ት ጐል ነው የሚ ጫወት ም
ከ ኢትዮጵያ ጋር ብን ቀላቀል ብዙ የሚ ለወጥ ነገር የ ለ ም	ከ ኢትዮጵያ ጋር ብንን ክለብ ብዙ የሚ ለ ው ነገር የ ለ ም
አሁን ባለ በት ሁኔታ ከ ቀጠለ ጭራሹ ኑ ውድድሩ እንዳይጠፋ ያሰጋ ል	አሁን ባለ በት ሁኔታ ከ ከተ ጋፉ ውድድሩ እንዳይ ፈላ ል
አገሬ የ መጣሁ አልመሰለ ኝም አፓርታይድ ን አስ ታወሰኝ	አገሩ የ መጣው ን አሰልጣኝ ም ቆታዊል አስ ታወቀ ች
ይህ ሲሚንቶ ባህር ዳር ላይ ም የሚ ሸጠው በ ስልሳ አምስት ብር ነው	የ ሲኒቶ በ ሀገር ጋር ላይ የሚ ሰጠው በ ስልሳ አምስት ነው
ሱዳን ና ኢትዮጵያ በ ድንበር ጉዳዮች ዙሪያ ተነጋገሩ	ሱዳን ና ኢትዮጵያ በ ድንበር ጉዳዮች ዙሪያ አቀረቡ
የ ባህር በር ቢ ኖረን ይጠቅ መናል	ኢህአዲግ በሩን ሄደ ን ይ ጠቁ ናል
በ ሙያው ለ ብዙ ጊዜ ሰር ቻለሁ	በሚያ ው ለ ብዙ ጊዜ ሰር ቻለሁ
ድሮ ከ ህዝብ የሚ ሰበሰበው ግብር ነበር	ዘንድሮ ከ እሚ የሚሰም ሰው ልጅ ነበር
የመንግስት ጋዜጠኛው ኢህአዴግ ን በ ዘረኝነት ከሰሰ	የመንግስት ጋዜጣው ን አቋም ግን በደል ነት ቀርሰ
ማጥቃቱ ን የ ጀመረችው ኢትዮጵያ ና ት	መሬቱ ን የ ጀመረችው ን ኢትዮፕያ ና ት
ዛሬ በርካታ ችግሮች ከ ፊታችን ተደቅ ነዋል	ዛሬ በ በርካታ ችግሮች ፊታችን ተደቅ ነዋል
እውነታው ንም በ አላህ ስ ም አ ረጋግጥ ልኝ	ችሎታው ን ባ መለከት ም ን አላውቅ ም
ጦርነቱ እንደ ገና ሊ ቀሰቀስ ይችላል	ውጤቱ እንደ ገና ሊገባ ይችላል
እስካሁን ያስመዘገበ ው ውጤት ም የሚ ያበረታታ ነው	እስካሁን ያስመዘገበ ው ምክንያት ም የሚ ያረጣ ነው
ክለቡ ዘንድሮ አጀማመሩ ጥሩ ነው	ክለቡ ዘንድሮ አርማ ጥሩ ነው
ቤተ ክርስቲያኒቱ ም ሀገሪቱ ም አንድ ታላቅ ሰው አጡ	በ ፕሬዝዳንቱ ም አገሪቱ ን ማግኘት አለ ብን
ሀጂ መሀመድ ወሌ መልእክት አስ ተላለፉ	አይዞ ሽ መ ዋዠቅ አስጬ ም
እንዲ ህ ያለ ነገር አይወጣ ኝም	እኔ ለ ነገር አይደለም
ም ንም የሚ ጸጽተኝ ነገር የ ለ ም	ም ንም የሚ ያሰኝ ነገር የ ለ ም
ተፈናቃዮች ወደ የ ክል ላችሁ ግቡ ተባሉ	ተፈናቃዮች ወደ የ ተያዘው ሽግ ተባረሩ
አንዴ ም ግን ተቀባይነት ሊ ያገኝ አልቻለ ም	አንሚ ግን ተቀባይነት ሊ ያገኝ አልቻለ ም
የ ኤድስ በሽታ ና የ ሻእቢያ ወረራ ጸረ ልማት ናቸው	የ ኤድስ በሽታ ና የ ሻእቢያ አስተዳደር ልማት ናቸው
ጦር ሲላክ በት በ ግብጾች ጉያ ይደ በ ቃል	ተኩስ ላዚዮ በ ግብጾች ጉባኤ ላይ ይነገራ ል
አሁን ጊዜው አይደለም ያላ ለ ኝ ሰው የ ለ ም ነበር	አሁን ጊዜው አይደለም ላይ ለ እኔ ሰው የ ለ ም ነበር
በ መላው ሀገሪቱ የ ተዘረጋ ፕሮጀክት አለ	በ ላኩቱ የ ተዛባ አመለካከት አለ
በ ስፖንሰር ከተገኘ ገቢ ነው እንጂ	እጀ ጐልርዳ ፋው ሰው ነው እንጂ
ከዚያ ውጭ የምን ለ ው አይ ኖረን ም	እስከዚያ ው ነው የምን ለ ው
ጠንካራ ው ዩናይትድ እየ ተነቃነቀ ነው	ቀራጺ ው ው ውጤት ተ ባለ እየ ተጠቀ ነው
ፍየል ከ መድረሷ ቅጠል መበጠ ሷ	ሌክ ከ መቀበል ስራ አስኪያጁ በ መጥ ተዋል
ሌሎቹ በ ሙሉ ጤነ ኞች ናቸው	ሌሎቹ በ ሙሉ መንገዶች ናቸው
ድፍረት ባይሆን ብኝ ስህተት ነው	ስህተት ያ ሏቸው ብንን ስህተት ነው
እነርሱ ከሌሉ ዋጋ የ ለኝም	እነሱ ከርሉ ጋር የ ለውም
የ ጸጥታው ምክር ቤት ማሳሰቢያ ላ ከ	እዚህ ም ምክር ቤት ነው አላልኩ
ይሄኔ መለስ ነቃ አለ	ይህም መልእክት አለ
ግን ይህ ሁሉ ውሸት ነው	ግንቦት ሁሉ ጮህ ነው
አለበለዚያ ግን ከ መሪዎቹ እየራቀ ነው	አ መዛ ግን ከ መሪዎቹ እየ ራረ ነው
እሱ ም ራሱ ችግር አለ በት	እሱንሶች ችግር አለ በት
ሌላው የ ሜዳ ጉዳይ ነው	ሌላው የ ሜዳ ጉዳይ ነው
